春来眼际	喜上眉梢
春光普照	福气长临
春和景明	物阜年丰
春降大地	福满人间
春明花艳	民富国强
春燕剪梅	喜鹊登春
党兴国旺	物阜民康
风清云静	日暖花香
光华大地	伟业中天
国臻大治	民奔小康
蕙兰并茂	桃李争芳
江山永固	广宇同春
椒花献颂	柏酒迎春
九州竞秀	七耀同辉
九州日丽	五湖景新
九州溢彩	五谷飘香
满园春色	一团和气
梅传春讯	雪兆丰年
全家福气	满院春光
鹊传喜讯	风送佳音
群芳斗艳	百业争荣
人歌四化	鸟唱三春
瑞雪辞岁	腊梅迎春
三春放彩	五福生根
三春淑景	四季宜人
山河秀丽	岁月辉煌
山河永固	大地同春
山河壮丽	日月光华
树承雨露	花沐春光
鹊送喜报	鸡传佳音
百事可乐	万象更新
百顺为福	六合同春
财源茂盛	人寿年丰
春安夏泰	秋稔冬祥
春风及第	瑞霭盈门
春光满室	瑞气盈门
春和景丽	物阜人康
春透寒梅	韵谐青竹
风调雨顺	国盛人和
风光胜旧	岁序更新
风迎新岁	雪兆丰年
河清海晏	人寿年丰
华灯飞彩	喜炮迎春
江山壮伟	桃李芬芳
九州日丽	四化春新
梅开佳景	雪兆丰年
梅映红日	雪兆丰年
门迎百福	户纳千祥
人增寿纪	天转阳和
三山生色	五湖呈祥
山川添秀	大地回春
诗书门第	陶淑人家
岁当盛世	人逢华年
岁丰人寿	春和景明
百族共乐	两岸同春
春风送暖	政策归心
家和业旺	国泰民安
江山若画	岁月如歌
民夸盛会	国展宏图
五羊献瑞	八骏呈祥
白雪融腊	红梅赋诗
爆竹报喜	楹联迎春
爆竹辞旧	桃符迎新
垂杨系马	沙岸泊船
春风梳柳	时雨润苗
春光九十	气象万千
春回柳眼	红人桃腮
春回柳叶	赋献梅花
春临宅第	喜上梅梢
春浓山腹	梅放岭头
春为岁首	梅占花魁
春有新意	景无旧观
椿庭庆集	棣圃春浓
冬迎梅至	春伴燕归
蜂抱花须	鱼吹柳絮
蜂翼弄娇	燕泥衔须
高堂结彩	华宅生辉
光饰竹径	影透花荫
红楼旭日	绿柳芳春
红梅吐蕊	绿竹催春
花开富贵	竹报平安
花香四季	月满一轮
花迎喜气	鸟唱春光
怀同霁月	量洽春风
惠风和畅	化日舒长
江山永固	日月长恒
九州国泰	六合春新
腊梅报喜	飞雪迎春
兰芳春日	桂馥秋风
龙腾虎跃	水啸山吟
龙兴华夏	燕舞阳春
龙吟国瑞	虎啸年丰
绿柳吐絮	白杨飞花
民生有幸	国运无疆
年丰人寿	景泰春和
年年如意	处处春风
牛耕绿野	虎啸青山
千峰月色	五湖春光
乾坤正气	日月光华
群鸥戏水	众鹤游天
人登寿域	世跻春台
人游化日	天与长春
人臻五福	花满三春
日上花梢	莺穿柳带
日薰春杏	风送腊梅
三江生色	四海呈祥
山川毓秀	松柏长春
山间明月	江上春风
时和景奉	雪瑞花奇
岁且更始	时乃日新
岁通盛世	人肇华年
抬头见彩	动手生财
唐虞盛世	天地长春
天开长乐	人到恒春
天开文运	人喜春暘
天涯月色	芳草春晖
香飘四季	春满九州
祥云捧日	玉树临风
新年初气	古国雄风
新岁献瑞	腊梅迎春
萱庭日永	兰室春和
阳春烟景	锦绣文章
阳春召我	淑气宜人
遥山耸翠	远水生光
一声爆响	万里春回
鱼游深水	鸟占高枝
与山同静	随地皆春
鸢飞鱼跃	燕语莺啼
韵耐春风	清宜夜雨
载瞻星气	如写阳春
鸡鸣晓旦	燕舞阳春
金牛贺岁	玉鼠回宫
人喜盛世	鼠兆丰年
同瞻马首	共沐春光
百花齐放	万马奔腾
彩云追月	骏马迎春
竹梅品格	龙马精神
云边雁断	陇上羊归
龙腾盛世	马到长安
一轮红日	三代春风
国强物阜	民富年丰
神蛇瑞岁	骏马祥年
万方春色	千顷湖光
万民便利	百货畅通
百花齐放	万木争荣
百花齐放	万木争春
百花齐放	四海同春
百花齐放	万福频臻
百年盛纪	一代精英
财亲智慧	福伴文明
铲除腐败	保持清廉
城乡比翼	山海扬辉
城乡比翼	工农齐飞
储金备患	积谷防荒
春风得意	科气致祥
春风化雨	壮志凌云
春风及第	政策归心
春风送福	喜气临门
春光播福	和气致祥
春光满面	瑞气盈门
春光满院	瑞气盈门
春光似海	盛世如花
春光永驻	特色频臻
春和景丽	国泰民安
春和景秀	物阜民康
春回大地	国振雄风
春回大地	日暖神州
春回大地	福满人间
春临大地	福满人间
春临大地	喜到人间
党恩浩荡	春意盎然
鼎新革旧	豫立亨通
东风化雨	政策归心
斗星指路	旭日辉春
法制天下	春满人间
风光胜旧	岁月更新
风和日丽	人勤地丰
风流四化	富裕千家
风正国强	物阜民安
凤鸣盛世	龙有传人
福随春至	富伴勤来
光辉世纪	春满神州
国兴两制	户纳千祥
国臻大治	民乐小康
过年最乐	读书更佳
河山溢彩	华夏增辉
弘开盛纪	欢度新春
红梅映日	绿柳催春
红旗引路	翠柳迎春
红旗映日	瑞雪迎春
花明柳暗	山复水重
花香世纪	福满门庭
华灯溢彩	喜报迎春
华坛竞秀	文苑争芳
化臻上理	福享共和
积极进取	勇敢拼搏
家传美德	国展宏图
艰苦奋斗	自力更生
江山不老	神州永春
江山不老	祖国永春
江山不老	祖国长春
江山如画	大地皆春
江山壮丽	桃李芬芳
金瓯永固	玉宇长清
九州安定	万众团结
九州共庆	两岸同春
九州生瑞	四海腾欢
九州生色	两岸连心
九州永泰	四季长春
巨龙奋起	祖国繁荣
开门纳福	举步迎春
科学致富	勤俭持家
励精图治	除旧布新
励精图治	振兴中华
柳丝垂岸	燕尾点波
龙吟虎啸	腊尽春归
绿化祖国	林茂粮丰
绿眠芳草	红插山花
梅传喜讯	雪兆丰年
梅花笑雪	柳浪推春
梅开春色	国展宏图
梅映红霞	雪兆丰年
民富国强	人寿年丰
民欢大有	国庆小康
年丰人乐	国富民强
普天同庆	日月增辉
齐歌四化	共庆三春
千门大喜	万户高歌
勤劳致富	科学兴邦
青春许国	斗志凌云
鹊传喜报	风送佳音
群芳斗艳	百业争雄
群芳斗艳	百家争鸣
人逢盛世	岁值年华
人逢盛世	鸟唱新春
人歌四化	鸟鸣三春
人和政美	国泰民安
人和政稳	世盛邦兴
人间改岁	天下皆春
人民万岁	祖国永昌
人民伟大	政策英明
人勤春早	国泰民安
人勤春早	民富国强
人勤春早	物阜年丰
人勤物阜	国泰民安
三通国瑞	两制邦兴
三通国瑞	两制人祥
三星拱户	四柱擎天
三阳开泰	两岸连心
三阳启泰	四化兴邦
山河似锦	岁月更新
山河溢彩	岁月流金
山欢水笑	物阜民康
山青水秀	地利人和
山青水秀	国泰民安
神州巨变	世纪更新
神州巨变	祖国腾飞
十分春色	万里鹏程
时和世泰	人寿年丰
桃李争艳	春色满园
天增岁月	春满京城
同奔四化	共赏百花
同奔四化	共奉一心
同创大业	共绘鸿图
同迎盛纪	共贺新春
团结治国	实干兴邦
万方有吉	四季呈祥
万民有庆	四海皆春
万民有庆	百族共中
万事如意	四季平安
五星拔地	四柱擎天
五星永耀	四化长兴
喜辞旧岁	笑迎新春
喜登新纪	乐步锦程
小康在望	大业敢攀
心存四化	手绣三春
欣逢盛世	喜庆新年
行臻康泰	志展宏图
雄文五卷	伟业千秋
业兴来者	龙有传人
一帆风顺	四季平安
一国两制	同舟共荣
一元复始	百福骈臻
一元复始	万象更新
移风易俗	除旧布新
迎春接福	除旧布新
云霞锦绣	道路康庄
着眼四化	立足本职
自强不息	民志长生
九州日丽	四海春新
东风拂面	喜气盈门
东风入户	喜气盈门
春风得意	丽日舒怀
电灯守岁	炉火迎春
钢花赛日	马达迎春
金鸡报晓	神犬驱邪
闻鸡起舞	放犬缉私
猴扫妖氛	岁纳祯祥
猴桃献寿	鸟语迎春
龙腾虎啸	腊尽春回
丹凤来仪	金鸡报晓
猴岁呈祥	鸡年纳福
神猴辞岁	金凤迎春
雄鸡唱韵	大地回春
藏龙卧虎	人杰地灵
况逢龙岁	绝胜鹏搏
小龙辞岁	骏马迎春
六畜兴旺	五谷丰登
六畜兴旺	二气雍和
金龙述职	银蛇报春
龙飞蛇舞	燕语莺歌
丙辉瑞应	子庶丰登
丙名世德	子夜凯旋
丙年春满	子夜灯红
丙年凤仪	子夜钟鸣
丙年兴旺	子民腾欢
子年人瑞	丙岁春温
子年润泽	丙火兴隆
子孙奋发	丙火辉煌
子夜为鼠	丑时属牛
发扬高雅	歌舞升平
马驰万里	羊恋千山
羊肥马壮	国富民丰
羊迎大吉	岁纳永康
年年保险	岁岁平安
八方秀色	一室清辉
八路进宝	四方来财
长空溢彩	大地流金
春风催绿	江山映红
春光骀荡	国步龙腾
春燕剪柳	喜鹊登梅
春盈四海	花漫九州
淡泊明志	平易近人
东风解冻	春日载阳
风和日丽	鸟语花香
风清日丽	鸟语花香
福星高照	万事亨通
高歌猛进	勇往直前
国家兴旺	人民安康
国强民富	政通人和
海阔鱼跃	天高鸟飞
红梅点点	春意融融
华灯飞彩	喜爆放红
举国安定	全民团结
军民义重	雨水情深
克勤克俭	为国为民
龙飞凤舞	月满春盈
梅开五福	竹报三多
莫看人短	不恃己长
年逢大有	日过小康
勤能补拙	俭可助廉
勤能补拙	俭以养廉
勤能补拙	学可医愚
庆云兆日	芳草迎春
鹊送喜报	风传佳音
人欢马叫	春和景明
人勤春好	民富国强
人心喜暖	鸟语辞寒
三更猪去	五夜春来
三江春水	五岳青松
山清水秀	鸟语花香
诗书门第	礼义人家
树头银花	心上春光
说真心话	做老实人
四海生色	五湖呈祥
抬头见喜	举步生风
闻鸡起舞	跃马争春
五星高照	四海欢腾
心存爱国	志在为人
心上美景	窗外红梅
新春伊始	福寿即来
一家瑞气	万里春光
一年肇始	百业兴隆
一派正气	两袖清风
一堂春色	七巧良缘
英豪济济	阵势堂堂
莺歌燕舞	虎跃龙腾
蒸蒸日上	欣欣向荣
主欢客乐	近悦远来
祖国统一	台湾当归
吉日唯戊	太岁在寅
门心皆水	物我同春
安邦兴世纪	举国庆长春
安定春风畅	富强国力雄
安定千家乐	辛勤五谷香
安定清平世	祥和幸福家
安定万民喜	团结百事成
八方盈正气	四化涌春潮
白鹅游暖岸	金马啸长风
白云抱幽石	绿竹媚清涟
百川赴东海	众星拱北辰
百花春气象	万树绿云烟
百花开锦绣	万马起云烟
百花开田野	双燕入农家
百年推甲子	福地在春申
百年新世纪	万里好河山
百鸟鸣春意	五星灿国门
百业农为本	万灵猴占先
百业农为首	千行银作根
百业兴旺日	五谷丰登时
爆竹传吉语	腊梅报新春
爆竹传吉语	腊梅吐幽香
爆竹传笑语	腊梅吐幽香
爆竹声声脆	梅花朵朵红
爆竹欣祝福	银蛇喜迎春
笔耕桃李茂	德育子孙贤
笔绘丰收景	笙歌幸福年
笔落惊风雨	诗成泣鬼神
碧水流新韵	青山笼彩霞
碧血催桃李	丹心育栋梁
碧野青蛙叫	黄山松鼠鸣
丙辉觇瑞应	子庶庆丰登
丙辉腾瑞气	子庶乐丰年
波平两岸近	月朗一家亲
伯乐荐骏马	良师育良才
不贪明赤胆	寡欲见清心
布谷迎春叫	牵牛接福来
财如春水发	喜似雪花飘
财源千里广	德誉万年长
财源通四海	春色满人间
彩蝶凌空舞	鲜花应时开
彩云笼碧岫	丽日映清波
彩云捧旭日	朝霞染红梅
残云随雪逝	美景应春来
苍松随岁古	绿竹与年新
苍松随岁古	子鼠与年新
草发黄牛乐	春新紫燕歌
草枯鹰眼疾	霜尽马蹄轻
草绿黄牛卧	松青白鹤栖
草暖青牛卧	松高白鹤眠
茶花知暖意	芳草见春心
蟾宫降玉兔	庭院绽红梅
福满勤劳第	春临和睦家
福气凝门户	春光入画图
福随新岁至	运伴好年红
福同时共彩	人并物皆春
富贵三春景	平安两字金
富进勤劳户	福临和睦家
富临勤俭户	春绿文明村
富随科技户	春爱勤劳家
富随科技户	福伴文明家
富裕勤中出	清廉俭里来
富自勤民出	廉当俭里求
改革春潮涌	创收喜讯传
改革铺富路	开放上新阶
改革强邦路	升平治国基
改革生新瑞	迎春歌治平
改革兴伟业	开放展雄风
改革英雄业	勤劳幸福家
干劲惊日月	奇志壮河山
钢花喷四海	铁水流九州
高歌庆新岁	强音颂早春
高歌新世纪	大庆小康年
高崖伏虎啸	茅庐卧龙飞
革命千秋业	江山万代红
耕田能获宝	养兔不守株
功期四化日	众望一统时
共和三尺剑	光复一戎衣
共莺传捷报	赤兔踏春光
共祝升平日	同沾大有年
孤村芳草远	斜日杏花飞
古韵江山赋	新春世纪风
故国山河秀	龙年世纪新
故岁今宵尽	新年明旦来
关心下一代	盛意播千秋
观国庆盛典	写世纪宏篇
观海知心远	登山觉眼明
官廉千姓福	风正万年春
官清民乐业	家富国增辉
官正民心顺	风清社稷安
光风千日暖	丽景百花妍
光辉盈世纪	春色满神州
国安民有福	民富国无忧
国登强盛境	民过幸福年
国登强盛境	人过富裕年
国登强盛境	民奉赤诚心
国富金瓯固	民安玉镜圆
国富千邦敬	家和万事兴
国富千秋泰	龙腾万事兴
国富千山秀	家和万事兴
国富山河壮	人勤岁月新
国富声威远	家和福气多
花沐春雨艳	福依党恩生
花随春意发	富自政通来
花香春正好	燕语日初长
花香丰稔岁	燕舞吉祥图
花香能醉蝶	柳色欲迷莺
花香招鸟语	马跃起龙图
花笑熏风暖	鸟歌盛世新
花馨招蝶舞	国瑞引龙腾
花应新春放	鸟为盛世歌
花迎春日艳	民浴党恩深
花迎红日放	心盼彩云归
花迎红日放	心向北京歌
花绽春光谱	马驰中国风
华堂来紫燕	乔木倚青云
华文春日丽	瑞色紫云高
华夏开新纪	英才展壮猷
华夏山川秀	新春气象殊
华夏山河壮	人民岁月长
华夏腾飞日	黎民富裕时
华章歌盛世	红对庆新春
化雨千山果	和风万树花
欢度九州节	讴歌四海春
欢度新春节	高歌小放牛
欢歌遍华夏	春色满神州
欢歌飘四海	妙舞颂三春
欢歌盈大地	笑语满神州
欢歌盈大地	春意满神州
黄金新岁月	锦绣好前程
黄牛耕碧野	白首乐红楼
黄牛耕九野	白马战疆场
黄牛耕绿野	猛虎啸青山
黄牛耕沃野	紫气笼新春
黄山松鼠跳	绿野早春归
黄山松鼠跳	子夜阳春来
黄莺歌红梅	紫燕舞翠柳
黄莺鸣翠柳	金鼠恋苍松
黄莺鸣翠柳	紫燕剪春风
黄莺啼暖树	紫燕衔新泥
会心传喜事	迎面笑春风
鸡催千里晓	春启万家门
鸡催万里晓	春启千家门
鸡鸣天放晓	政改地回春
鸡鸣万户晓	鹤舞一年春
鸡声窗前月	人笑福里春
鸡声催晓读	鸟语唤春耕
鸡声天下曙	春意海南潮
吉门沾泰早	和里得春多
佳节家家乐	新春处处欢
佳节吟妙对	盛世赋新联
佳联歌盛世	瑞雪兆丰年
佳联歌四化	妙对颂群英
佳联歌幸福	美酒庆团圆
家和万事顺	春暖百花香
家家养猪宝	户户发羊财
家建文明户	寨追模范村
家睦迎春早	楼高得月先
家室百年乐	江山万代春
家迎千事喜	门对一园春
嘉会芳林苑	高歌翰墨流
建功光胜纪	创业谱新章
建文明盛世	谱幸福新歌
江河霜练净	峰峦玉堆高
江山澄气象	冰雪净聪明
江山澄气象	事业现风流
江山多俊秀	时代更风流
江山放异彩	日月生新辉
江山飞丽藻	花柳发韶光
江山开胜景	人物倍风流
江山留胜意	杨柳荟卿云
江山披锦绣	事业铸辉煌
江山千古画	世纪百年春
江山千古秀	花木四时新
江山千古秀	华夏万年春
江山千古秀	花木四时春
江山千古秀	祖国万年春
江山千古秀	日月一时新
江山千古秀	大地万年青
江山千古秀	天地一家春
江山千载美	祖国万年春
江山荣秀色	大地发春晖
江山如有待	春色总无私
江山添秀色	大地换新颜
江山添秀色	大地发春华
江山万年固	天地一家春
江山无限好	祖国万里春
江山欲揽胜	梅柳笑迎春
江山增润色	桃李艳春光
江山增润色	祖国普春光
江山增秀色	大地换新装
将军爱战马	农夫喜黄牛
脚踏小康路	胸怀大市场
教为百年计	师受万代尊
教育呈新貌	园丁育好苗
阶前生百福	檐下纳千祥
节日人共乐	神州地皆春
借得山川秀	迎来世纪新
金猴方启岁	绿柳又催春
金鸡歌国泰	义犬报民安
金鸡交好卷	黄犬送佳音
金鸡日独立	紫燕春双飞
金鸡迎曙色	玉兔揽春光
金鸡争唱晓	玉兔喜迎春
金菊凌霜放	红梅傲雪开
金缕春溢彩	玉雕雪迎祥
金马辞旧岁	银羊贺新春
金蟒穿云去	紫骝踏雪来
金牛奔盛世	紫燕舞新春
金蛇送冬去	骏马报春来
金蛇祥万里	骏马端千家
锦绣江山画	风流世纪春
锦绣山河美	光辉天地春
锦绣山河美	光辉大地春
锦绣山河壮	缤纷春色娇
经商须诚信	从政必清廉
旌旗飘玉宇	箫鼓庆新春
旌旗扬特色	华夏展宏图
精耕禾吐秀	细作土生金
精微慈母意	严谨铁面师
九陌连灯影	千门庆月华
九天鸿鹄奋	四化巨龙腾
九天腾丽日	四野沐春风
九天悬丽日	七彩耀神州
九霄悬丽日	八骏跃雄程
九野春光好	八方气象新
九域歌国泰	八方颂党恩
九域迎旭日	八方庆新春
九州春风暖	四化伟业新
九州春日丽	七月彩云归
九州春色好	四化热潮高
九州春意闹	四化宏图开
九州春意闹	四海宏图开
九州大治景	万户小康图
九州逢春绿	百业开门红
九州歌改革	四海庆升平
九州歌盛世	四海颂升平
九州歌四化	十亿庆三春
九州归一统	两岸共千春
九州花似锦	五岭诗如云
九州花似锦	十亿面皆春
九州辉特色	五岳壮奇观
九州江山美	两制政策新
九州开骏业	四海起祥云
九州开泰运	万福启春华
九州来春色	四化绘新图
九州龙气概	万众马精神
九州期富裕	八面庆繁荣
九州期一统	六合庆双归
九州清平乐	四方正气歌
九州庆大治	万户乐小康
九州腾瑞气	七曜发祥光
九州添胜景	三峡出平湖
九州同一脉	两岸共千秋
九州欣瑞彩	百姓乐升平
九州兴特色	六合荡春风
九州兴特色	万众沐春晖
九州兴特色	四化奋鹏程
九州兴特色	十五展宏猷
九州扬正气	三讲荡清风
九州扬正气	七彩绘蓝图
九州盈瑞气	万户沐春风
九州盈喜气	六合洽春风
九州尊知识	四化重人才
酒绿千家醉	灯红万户春
酒热诗歌壮	梅红天地新
酒饮千家福	歌唱满江红
旧年除旧俗	新岁启新知
旧年除旧岁	新年启新知
举杯歌幸福	向党报恩情
举国援西部	全民仰北京
举旗驰大道	随党越雄关
举头闻鹊喜	开户见春来
军旗飘盛世	精兵振国威
君作玉鞭赋	我吟金棒诗
骏马奔千里	吉羊进万家
骏马春常在	吉羊福又添
骏马归山野	灵羊爱草原
骏马生双翼	鸿图壮九州
骏马腾远志	灵羊壮新风
开放财源广	公平信誉高
开放创奇迹	改革建大功
开怀迎世纪	举臂揽春风
开门闻喜讯	举步见春光
开时代列车	当四化标兵
开心跟党走	得意踏春行
凯歌辞旧岁	骏马迎新春
凯歌送旧岁	骏马迎新春
凯歌迎世纪	翰墨写春秋
凯歌盈大地	春光满神州
看江山如画	喜世纪皆春
科学铺富路	廉政架金桥
科学铺富路	政策架金桥
客岁送金鼠	今年买铁牛
跨峥嵘岁月	奔锦绣前程
葵花开向日	酒圣欲冲天
鲲鹏飞玉宇	骐骥跃神州
腊鼓催青骏	春风策紫骝
腊鼓催穷去	金狮送富来
腊鼓催神骏	春风送吉羊
腊梅辞旧岁	春信报吉祥
腊梅千门秀	春雨二月花
腊月初临福	新年又报祥
雷鸣龙起蛰	泥暖燕含春
礼言改正朔	书曰作新民
理财须勤俭	为政必清廉
醴泉喷宇宙	甘露洒神州
历尽严冬冷	更知春日和
立马昆仑小	腾龙世纪新
立马千山矮	迎春万木荣
丽日当空照	春风扑面来
丽日沐华夏	惠政润神州
帘抖三冬雪	窗含万里春
帘外生紫气	阶前度春风
联写迎春语	诗题献岁词
廉风昌国运	善政悦民心
廉风清大地	正气振中华
廉风清玉宇	特色灿金瓯
廉风昭玉局	正气壮金瓯
炼钢为四化	创业炳千秋
良辰逢雪霁	瑞气霭春晖
两制圆玉璧	一统固金瓯
邻睦风亦暖	家和雪自香
林海春光好	雪原气象新
林有鸣心鸟	园多夺目花
岭上梅花艳	楼前曙色明
柳绿春江月	旗红骏马图
柳绿三春丽	梅红小院香
柳塘春水慢	花坞夕阳迟
柳絮随风去	桃花逐水来
柳眼凝眉绿	桃腮映面红
柳营晨试马	虎帐夜谈兵
柳枝揉雨绿	杏蕊闹春红
六合同春日	三阳开泰时
龙飞欣晓日	马到庆丰功
龙人歌盛世	鸟语话丰年
龙人臻万福	骏业炳千秋
龙蛇归大海	鲲鹏震九霄
龙腾翻巨浪	虎啸动春雷
龙腾丰稔岁	蛇舞吉庆年
龙腾吉祥到	马跃欢乐多
龙腾九万里	国步二千年
龙引千江水	虎越万重山
楼阁春光好	江山曙色新
楼观沧海日	帘卷泰山云
楼览江山景	门迎世纪春
楼台春日丽	世纪画图新
绿柳迎春舞	红花应节开
绿水闲润柳	春风漫拂花
绿野春风荡	紫薇燕子飞
绿叶扶花好	青春为国雄
绿意随春妙	豪情逐浪高
马辟长安道	羊开大吉春
马步康庄道	羊奔锦绣程
马驰昌盛路	羊报吉祥音
马驰金世界	羊唤玉乾坤
马带祥云去	羊挟惠风来
马带祥云去	羊铺锦绣来
马革酬壮志	羊碑纪丰功
马季催季马	牛群牧群牛
马留英雄气	羊会世纪风
马年腾大步	羊岁展宏图
马去雄风在	羊来福气生
马首开新纪	羊肠拓锦途
马嘶飞雪里	羊舞画图中
马岁荣华到	羊年富贵来
马踏春锦绣	莺歌世风流
马腾风雪舞	春到杏花红
马腾改革路	国展富强图
马蹄留胜迹	羊毫谱新歌
马蹄留胜迹	羊角搏青云
马蹄腾瑞雪	羊角触红梅
马拓康庄道	羊挟惠风来
马拓康庄道	羊铺锦绣云
马啸关山月	莺歌杨柳春
马有知途德	羊存跪乳恩
马跃康庄道	人迎幸福春
马跃庆丰年	羊鸣歌盛世
马跃阳关道	春回杨柳枝
马载祥云去	羊携惠雨来
马壮雄风在	羊临浩气生
满门辉德泽	举国倡文明
满门增瑞霭	阖家建文明
满山红叶落	何日彩云归
满眼春风绿	盈门喜气浓
满园芳草绿	万户春联红
满院春色好	一树梅花香
满院梅花好	一堂春色妍
卯门生喜气	兔岁报新春
卯门生紫气	兔岁报新春
梅报三春信	人迎四化风
梅花含白玉	柳色吐黄金
梅花开五福	竹叶报三多
梅花开五福	竹叶报三春
梅花飘香雪	杨柳荡轻烟
梅花喜瑞雪	芳草迎春晖
梅花迎瑞雪	芳草映春晖
梅开透春信	雪化见松贞
梅柳谈天好	燕莺语地新
梅香催腊去	燕翅携春来
梅香浮朗月	柳浪戏春风
梅心浴曙色	柳眼望春光
梅馨春意远	鹊韵福音长
梅绽香风远	柳摇春意浓
门含千山秀	楼览万里春
门阑生喜气	世纪足春光
门庭多喜气	山水遍春光
门庭千载福	世纪万方新
门外山河美	庭前草木新
密林藏伏虎	萝峰染晴云
妙手医百疾	红心为万家
民安由政善	家富赖人勤
民奔小康路	国臻大治年
民富九州乐	国强五岳高
民勤国致富	风正党增光
民心扶社稷	法治定乾坤
民心融四化	国策炳千秋
民殷思报国	岁稔喜迎春
民展凌云志	国开康盛年
民主春风劲	长征战鼓催
鸣莺传燕信	策马赴羊年
莫醉成功酒	愿加跃进油
南疆堆春色	西部叠彩霞
嫩柳千姿秀	腊梅万朵妍
嫩柳千姿秀	悄梅万态新
年丰人福寿	世盛景妖娆
年丰人增寿	春早福满门
年画年年画	对联对对联
年年歌大有	岁岁颂新康
鸟语传春意	花香透世情
鸟语喧花果	猴声啼水帘
鸟啭新年颂	花开盛世春
牛背飘春曲	鹊舌报福音
牛耕芳草地	鹊报吉祥年
牛耕千野绿	鹊闹一庭春
牛开丰稔景	燕舞艳阳天
牛铃飘翠岭	燕语暖春风
牛舞丰收岁	鸟鸣幸福春
暖日芳心吐	东风柳眼舒
讴歌焦裕禄	演唱孔繁森
蟠桃千岁果	温树四时花
盼河山一统	迎港澳双归
炮竹舞花彩	锣鼓谱佳音
凭智能创业	靠信息生财
屏开金孔雀	彩映锦华堂
破除旧习惯	表现新精神
破千年旧俗	立一代新风
普天歌盛世	举国颂廉风
普天开景运	大地沐春晖
普天开远景	大地转新机
普天开远景	大地焕新风
曝竹花万点	春雷惊三春
齐书创业史	共绘四化图
齐心奔富路	协力奋雄程
齐心奔富路	协力建家园
奇对天下事	妙联世间情
旗唯红色艳	月是故乡明
旗展千花笑	春来万马奔
旗展五星映	梅开四方香
气若春风净	心如秋水明
气正江山秀	风清世纪新
气正山河壮	春明雨露勤
千户迎晓日	四化荡春风
千家春不夜	万里月长明
千家春不夜	万里月连宵
千家春酒绿	万户对联红
千家春酒绿	万里稻花香
千家歌德政	万户沐春晖
千家歌盛世	万户乐新春
千家皆春色	五谷呈丰年
千家迎新岁	万户庆丰年
千门杨柳绿	万户梅花红
千门迎晓日	四化趁春风
千山飞彩凤	四海跃金鳞
千山花烂漫	百族舞翩跹
千山披翠绿	万里尽朝晖
千祥迎九域	万众夺三番
牵牛花报喜	布谷鸟催春
前光增百福	后裕纳千祥
乾坤风雷荡	中华日月新
乾坤浮正气	世纪会春风
勤俭千载富	和睦一家春
勤俭穷变富	苦干土成金
勤劳方致富	和睦可生财
勤劳活百岁	节俭富千秋
勤劳家家富	节俭年年丰
勤劳能致富	自学可成才
勤劳能致富	和睦可生财
勤劳能致富	安定可兴邦
勤劳能致富	科技可兴邦
勤劳千事顺	信用万年馨
勤劳携福至	科技引财来
勤是摇钱树	俭为聚宝盆
勤为摇钱树	俭是聚宝盆
勤政廉为首	爱民德乃先
青春光日月	赤帜映乾坤
青春献祖国	世纪属人民
青山多画意	春雨润诗情
青山披锦绣	绿水溢春华
青山披锦绣	绿水泛春光
青山添秀色	碧海泛春潮
轻烟芳草地	微雨杏花村
清风迎盛世	旭日耀新春
清廉昌世纪	正气壮神州
清廉从政事	勤俭树家风
清廉宜治国	勤俭益发家
清溪吟雅韵	皓月洒春晖
清音歌盛世	妙笔著华章
清音歌盛世	美酒贺新年
情随飞雪舞	诗伴落梅吟
晴点龙飞去	珠还蛇舞来
擎旗弘大业	斟酒擎英雄
擎旗尊马列	荷戟保江山
庆洽时方至	春来日渐长
庆三春佳节	展四化宏图
庆三阳开泰	喜万象更新
庆三阳开泰	贺万象更新
庆新春肇始	祝大业终成
庆一元肇始	祝四化图新
庆云飞五色	瑞气绕三台
曲奏强国调	歌吟富民诗
祛邪方扶正	除暴为安良
全民歌善政	举国庆升平
全民歌盛世	举国庆新春
全民扬正气	举国颂清平
全民扬正气	举国扫歪风
全心关国事	两手建文明
犬守平安日	梅开如意春
鹊语红梅放	鼠年喜气浓
群星瞻北斗	万马啸东风
群英奔四化	大地绘三春
人催千里马	国展五星旗
人逢如意事	牛舞艳阳春
人歌新世纪	燕舞好春光
人和春永驻	政稳世清平
人欢为体健	鼠硕因年丰
人间春尽染	天下乐相融
人间春尽染	天下乐相容
人间多美景	大地足春光
人间万象转	天地一家春
人民奔四化	祖国贺万年
人民歌大治	祖国庆长安
人民歌永泰	祖国庆长春
人勤春光美	家和喜事多
人勤春来早	谷满月更圆
人勤春来早	草发牛更肥
人勤春来早	政好岁时丰
人勤春永驻	法治国长兴
人勤春永驻	法治世长安
人勤春早至	国富农先行
人勤家业旺	国治民气高
人勤家致富	世盛国长春
长歌遍华夏	春风满神州
长虹七彩锦	盛世九州春
长空盈瑞气	大地遍春光
长天飞捷报	特色壮神州
长治久安日	小康大有年
长中华志气	览世纪春光
常鼓兴邦志	永怀报国心
敞怀谈改革	奋力建文明
朝曙江山丽	春辉世纪新
朝霞映红日	新雨润春蕾
朝阳澄玉宇	壮志化宏图
车行万里路	人歌四化功
承恩占沆瀣	接武引星辰
承千年学识	教一代新人
城阙千门晓	河山万簇春
城乡千户晓	河海万方春
乘风腾骏马	兴国舞神龙
乘龙能揽月	策马喜迎春
池塘喜夜雨	庭院醉春风
持家勤与俭	建国富而强
丑时春入户	牛岁福临门
处处春光好	年年气象新
处处春光好	日日气象新
处处春光好	家家气象新
窗前柳泛绿	屋后花映红
窗前莺啼序	屋后蝶恋花
创千秋大业	育四有新人
创千秋伟业	开一代新风
创新光景好	入世地天长
创新光史册	改革树丰碑
创业勤为本	治国廉为先
春草当风劲	腊梅傲雪香
春草连天绿	羊群动地欢
春潮传喜讯	鼠岁报佳音
春城回北斗	烟树发南枝
春从今夜归	人于此时新
春促山河变	人描天地新
春催布谷鸟	人效拓荒牛
春催千山秀	花放万里香
春催杨柳绿	花放山河新
春到东风暖	旗开西部兴
春到风光美	家兴喜事多
春到千山秀	花开万里香
春到三晋暖	风催万里红
春度文明国	喜盈幸福家
春风初应律	花信旱传梅
春风传捷报	梅韵贺新年
春风传捷报	凯歌贺新年
春风传喜讯	瑞雪兆丰年
春风吹大地	淑气满人间
人勤家自富	政善国长兴
人勤三春早	地肥五谷丰
人人歌盛世	户户庆新春
人人歌盛世	户户庆丰年
人随春意泰	年共晓光新
人随春意泰	花献丰年红
人随春意泰	事共壮怀成
人饮春节酒	马渡风月关
人展鲲鹏志	国呈龙虎威
人醉辞年酒	家吟颂党诗
日出千山秀	花开万里春
日出乾坤秀	春来草木娇
日高柳生色	风暖莺送声
日亨君子道	天相吉人家
日丽春常驻	人和福永留
日丽花增色	月园鸟放歌
日丽开新纪	山河入画图
日丽山河秀	春辉世纪新
日丽山水秀	春暖花木荣
日暖春永驻	人和福永留
日暖三春美	雨滋万树荣
日日平安日	年年幸福年
日月光天德	云霞拥地灵
日月红光照	乾坤喜气多
日月华光照	乾坤春意浓
日月千秋照	江河万古流
日照家家暖	花开处处红
日照三春暖	花开九州红
日照三春暖	花开万里香
入世龙得雨	申奥马加鞭
入世天更阔	申奥水皆欢
入世迎挑战	向荣趁适时
锐眼观天下	妙笔写春联
瑞凝三秀草	春入万年枝
瑞气充红蕾	春风动绿枝
瑞气当窗霭	春光映户新
瑞气荡寰宇	兰馨溢神卅
瑞气回大地	江春入旧年
瑞气临门早	春香及第先
瑞雪飞万户	祥云绕千家
瑞雪漫天舞	红梅着意开
瑞雪飘万里	春雨润九州
瑞雪随冬去	和风伴春来
瑞雪迎春到	金牛贺岁来
瑞雪映喜报	彩门悬春联
瑞雪妆梅艳	春花映日红
瑞雪缀北国	鲜花绕南疆
瑞兆人间喜	春回世纪新
三春播喜气	万马荡雄风
三春花齐发	四化国振兴
三春辉玉宇	两制富苍生
三春开盛纪	万马闯雄关
三春桃李艳	九野稻粱香
三春添锦绣	四化展经纶
三山钟秀气	四海著春光
三通遂夙愿	两制起宏图
三羊开景泰	双燕舞春风
三羊开泰日	万事亨通年
三羊生瑞气	百鸟唤春光
三阳从地起	五福自天来
三阳开泰运	四季乐平安
三阳开泰运	四化展宏图
三阳开泰运	四季保平安
三阳临吉地	五福萃华门
三中开富路	四化上新阶
扫千年旧习	树一代新风
山川生瑞气	笔墨送祥光
山川新画卷	花鸟艳春光
山河舒锦绣	桃李竞芳菲
山河添秀色	大地浴春晖
山河添秀色	祖国尽朝晖
山河益壮丽	日月更峥嵘
山河增润色	世纪焕春光
山河增秀色	天地播春晖
山水含芳意	风云入壮图
山水吐芳意	风云入壮图
山桃发红萼	野蕨渐紫苞
山舞银蛇日	地披红装时
山远云多态	地近草自新
山月流古雪	风虎浴清泉
赏梅知腊尽	饮酒待春归
上林春色丽	乔木鸟音高
上苑梅花早	东风柳色新
上苑梅花早	重门柳色深
韶光开锦绣	春色上珠帘
蛇腾新世纪	马跃大中华
蛇舞长城雪	马嘶北国风
申年梅献瑞	猴岁雪兆丰
身容诗画里	家居画图中
深恩红赤日	忠实老黄牛
神鞭催骏马	祖国壮金瓯
神州常溢彩	大地永流金
神州春不老	大地年又新
神州春浩荡	寰海日光华
神州逢春绿	江山映日红
神州敷特色	盛世蔚清风
神州好事近	盛世彩云归
神州开玉宇	华夏架金桥
神州神韵足	盛世盛情多
神州抬望眼	壮志展宏图
神州腾异彩	祖国颂新章
神州新气象	华国大文章
神州兴骏业	壮志展宏图
神州臻百福	盛世集千祥
神州臻大治	民族肇中兴
神州争飞跃	健儿勇登攀
升平天下瑞	和睦世间春
生产随春长	幸福与日增
笙歌辞旧岁	羊酒庆新春
笙歌歌盛世	捷报报新春
盛世春光美	新年喜讯多
盛世春花艳	神州气象新
盛世春来早	丰年花正红
盛世春来早	丰年花正好
盛世丰稔岁	和谐幸福家
盛世开新纪	人民乐小康
盛世普天乐	新春遍地歌
盛世舒豪兴	春风聚大和
盛世臻百福	党恩惠万民
诗联抒壮志	丹青绘鸿图
诗吟新事物	笔描现风流
十分春色好	万户福音多
时好人如意	业锦福倍多
时雨堪雨我	春风好风人
时雨随风到	好花应讯开
豕去呈丰稔	鼠来报吉祥
豕去春无限	鼠来岁有余
世德家声远	政通国力雄
世纪百年史	神州万载春
世纪开心事	江山满目春
世纪新春意	江山妙画图
世界风雷荡	中华事业兴
世界风雷激	中华岁月新
世界开新纪	中华展壮图
世清春不夜	国盛景长明
世清风月静	年瑞雪梅香
世清民有幸	德厚福无边
世上无难事	人间有真情
世盛花盈树	春新月满楼
世盛江山稳	政廉气象新
世盛凭改革	花好仗春风
世盛千家福	花香万里春
世盛英才举	政通富路兴
世泰云生彩	年丰雪献花
世新开景运	国盛展宏图
世泽绵为善	家声振读书
事事都如意	虎虎有生气
事业千秋盛	江山万里红
事业随春长	风光逐日新
淑景凝新旭	晴光接彩霞
淑气临门早	春风及第先
淑气腾佳景	和风蔚早春
鼠趁三更去	牛驮五福来
鼠遁春风至	牛携喜气来
鼠来豕去远	春到景更新
鼠去粮满囤	牛来地生金
鼠为生肖首	春乃岁时先
鼠颖题春贴	鹊舌报福音
鼠至调新律	鸡鸣早报春
蜀锦莺梭织	春装燕剪裁
曙光迎盛世	旭日耀新春
曙光昭物彩	淑气焕人文
戍日耀吉瑞	狗年臻福祥
树社会正气	学雷锋精神
双珠莹特色	两岸荡和风
霜蹄千里骏	风翮九霄鹏
水清芳草茂	山碧彩云归
四海春春美	九州日日新
四海春风洽	千秋阳历长
四海春风洽	九州岁历长
四海春光好	九州气象新
四海皆淑气	九州尽春晖
四海连天浪	九州动地诗
四海迎新纪	五洲庆元春
四化春浩荡	前程日光华
四化风轮急	九州岁月新
四化宏图展	九州春意浓
四化千秋业	九州万年春
四化人心暖	九州春意浓
四季春为首	百花梅在先
四面青山抱	九州赤帜扬
四时春作首	三爱党为先
四时春作首	六畜马当先
四时春作首	万事公居先
四时花似锦	万众面皆春
四时开新律	九州度瑞年
四序开新律	三阳应庆期
随春听鸟语	与日赏花容
随心变冬夏	信手拈春秋
岁寒青竹瘦	春暖白梅香
岁寒三友雅	国富万民康
岁酒梅花酿	春衣紫燕缝
岁稔千门瑞	时和万户欢
岁首春到户	牛年福满门
岁岁春光好	家家富路通
岁岁平安日	年年如意春
岁岁升平世	家家幸福歌
岁新绵甲子	德厚富春秋
岁月随人好	山河照眼明
太平真富贵	春色大文章
桃红映人面	水绿织春光
蹄花沾晓露	柳浪饰春风
天酬勤与善	人尚纯和真
天地入胸臆	文章生风雷
天地英雄气	神州浩荡春
天地英雄气	山河浩荡春
天地英雄气	乾坤锦绣春
天地有正气	院庭沐春风
天高鹏展翼	路远马扬蹄
天寒梅骨傲	风暖草心香
天开清淑景	人乐庆和年
天开三春景	人描四化图
天开新岁月	地改旧河山
天开新岁月	人改旧乾坤
天开新岁月	民乐好春光
天清鹏展翼	风正马腾骧
天心随律转	人事逐年新
天涯芳草绿	华夏玉羊欢
天灾人无祸	民福党有恩
田园脱俗气	山水含清辉
田园无限美	山河分外娇
铁肩担道义	巧手绣乾坤
铁肩担四化	妙手绣三轩
铁肩担重任	妙手绘蓝图
听莺红杏曲	驻马绿杨荫
同赋小康对	共书大有年
同心兴大业	携手振中华
同修富裕路	共建文明村
同斟丰稔酒	共绘吉祥图
同志求真理	并肩闯难关
兔归皓月亮	花绽春光妍
兔归月影笑	花绽春光妍
兔毫推赵地	麟管锡张华
兔留丰稔景	龙腾瑞气年
兔岁添福气	龙人奋雄程
万方春浩荡	四海镜如澄
万家春酒绿	四化捷报红
万家腾笑语	四海庆新春
万家腾笑语	四海庆阳春
万里春光美	九州瑞气浓
万里春光暖	九州气象新
万马奔腾日	千门幸福春
万马奔腾日	九州幸福春
万马争飞跃	百花展笑颜
万民怀美德	四海乐尧天
万众思改革	群龙志腾飞
万紫千红地	花团锦簇天
往昔穷山坳	如今富人家
微风斜燕影	绿柳乱莺声
为子孙创业	替民族增光
伟业从头起	小康捷足登
伟业惊天地	神州入画图
伟业千古秀	神州万年春
伟业千年固	神州万代红
伟业千秋秀	神州万年青
未时骄阳艳	羊岁淑景新
渭北春大树	江东日暮云
文风香古国	德范誉千秋
文明创佳绩	科技显神功
文明辞旧岁	科技领先鞭
文明先醉月	改革早回春
文明新社会	锦绣好前程
文明新世纪	改革大文章
文坛生异彩	艺苑奏新声
文坛生异彩	艺苑溢芬芳
闻鸡欢起舞	跃马喜迎春
闻鸡思奋发	跃马抖精神
闻鸡先起舞	跃马共迎春
无私德乃大	不欺心自安
无心思旧景	有志领新潮
五星辉大地	四有育新人
五星辉玉宇	两制拓新程
五羊开玉局	万马闯雄关
五羊争献瑞	万马喜留春
物华天宝日	人杰地灵时
溪水鸣琴韵	春阳照华年
喜庆党风正	欢歌国运昌
喜鹊登高枝	红梅报春花
喜鹊登枝唱	红梅报春来
喜鹊登枝唱	乳燕衔春歌
喜鹊歌新曲	梅花早报春
喜鹊枝头闹	蝶蝴蕊上飞
喜三春添景	向四化进军
喜事开心脾	春光亮眼眉
鲜花沾春雨	好鸟舞东风
香牵两岸意	港纳五洲情
祥光凝比屋	春色入重帘
祥光盈九域	瑞色满神州
祥梅伴福到	瑞雪迎春归
祥云萦小院	丽日照高楼
小康舒岁月	大治固江山
小龙舞九州	大骥驰千里
效益凭改革	变化赖承包
笑脸迎春到	抬头见喜来
写兴邦颂史	奏创业新歌
心联千载业	手绘九州春
心头四化业	笔下九州春
辛苦创大业	未来展宏图
欣有鼠须笔	喜题燕尾书
新春歌大治	华夏乐中兴
新春添美景	盛世荡清风
新春添新景	佳节报佳音
新春新气象	好节好风光
新春迎玉兔	华夏壮金瓯
新风遍华夏	美景展神州
新风昌世纪	正气浩乾坤
新风开当代	春色耀人寰
新风开盛世	春色壮神州
新风增国祚	春色耀人寰
新年纳余庆	嘉节号长春
新年启新运	佳节迎佳人
新岁多吉庆	合家乐安然
新妆鼠嫁女	美景艳迎春
兴邦承伟略	富国赖良谋
兴邦多上策	富国仗良谋
兴邦多壮志	举业在华年
兴邦多壮志	盛世足风流
兴邦凭善政	治国靠文明
兴邦强国策	济世富民图
兴国必兴教	治贫先治愚
兴教千家乐	尊师万人钦
兴农铺富路	重教架金桥
星临万户动	月傍九霄悬
形势年年好	精神日日新
杏林春意暖	桔井活人多
杏林三月景	桔井四时春
幸福随春至	辉煌与日增
雄风鼓四化	温暖送千家
雄心遍地起	正气逐春来
雄心开骏业	壮志奋鹏程
旭日千门启	祥辉四望新
旭日舒清景	雄心展宏图
旭日祥云灿	春风化雨新
旭日云霞丽	春光世纪新
旭日照赤帜	高歌迎新春
雪飞天降瑞	梅落地到福
雪霁风云净	春晖世纪新
雪霁江山丽	花开岁月新
雪里江山美	花间岁月新
雪落千峰素	梅香万里春
雪洒山川秀	春来天地新
雪添千里景	富乐万民心
雪消残腊处	春到早梅边
雪消梅绽玉	风细柳摇金
雪影催年至	春光映岁归
雪映丰收果	梅传喜庆年
雪映丰收景	梅报富裕春
雪映丰收景	梅迎跃进春
雪映丰收景	梅报胜利春
雪映梅花白	春临柳色青
雪映梅花秀	春归柳色新
雪中飞赤兔	月下赶黄彪
雅量涵高远	清心鉴古今
烟花山际重	舟楫浪前轻
烟柳千家晓	风华百里春
演唱改革事	讴歌开放诗
艳阳照大地	春色满人间
燕剪芳菲锦	溪流翡翠川
燕剪千重霭	花开万里春
燕舞桃烟醉	莺歌柳浪轻
燕戏还檐际	花飞落窗前
燕莺新气象	龙马壮精神
燕语新华喜	龙腾大地春
燕语新年喜	莺歌大地春
扬鞭催骏马	把酒会春风
羊毫书特色	燕翼绣春光
羊毫抒壮志	燕梭织春光
羊毫舒远志	虎胆壮雄风
羊舞丰收岁	猴吟锦绣春
阳春播德泽	时雨润心田
阳春开物象	丽日焕新天
阳光凝大地	春色满人间
阳光凝大地	春色入人家
杨柳春风第	芝兰玉树阶
邀月君携酒	迎春我写诗
野火烧不尽	春风吹又生
业似春花发	人如骏马飞
夜草能肥马	生刍可壮牛
夜雨书声静	春风墨韵浓
一代英雄业	九州世纪春
一国行两制	四海庆团圆
一江春水绿	五岭杏花红
一年春作首	万事公为先
一年春作首	百事国为先
一曲迎春调	三杯祝福歌
一堂开淑景	万马会新春
一统江山秀	百年世纪娇
一夜春风暖	百年世纪新
一夜连双岁	五更分二年
乙朗芳草地	丑待吉祥年
乙颂初阳岁	亥迎多福春
鳦鸟传长发	苍龙协永绥
吟酒辞旧岁	举杯贺新年
寅年春锦绣	卯序业辉煌
银灯光禹甸	朗月照神州
莺歌歌盛世	燕舞舞升平
莺歌花更红	燕舞春又归
莺歌新世纪	燕舞好年华
莺迁金谷晓	花发锦城春
莺舞池边柳	牛耕陌上春
迎春芳讯至	白日彩云归
迎春接福日	足食丰衣年
迎春添新禧	开业发大财
迎春燕语巧	踏雪马蹄香
迎门有紫气	排闼看青山
影坛新苗壮	艺苑百花开
永作清廉仆	长扬改革帆
勇奔新世纪	乐做大文章
有德门庭瑞	无华品格高
有年皆丽日	无处不春风
有天皆丽日	无地不春风
有相皆虚妄	无我即如来
鱼跃清波澈	莺啼众绿新
与竹共修节	约梅同醉春
雨过千山润	春来百鸟鸣
雨露润花红	人醉春光中
雨润山河秀	花开岁月新
雨洒千山绿	风吹万树红
玉堂浮瑞气	金室耀祥光
玉堂开春色	琼树发秋香
玉兔蟾宫笑	红梅五岭香
玉兔迎春到	红梅祝福来
玉兔迎春至	黄莺报喜来
育人间桃李	扶社稷栋梁
欲圆强国梦	大展富民图
园荷浮小叶	细菱落轻花
远看山吐翠	近闻水流香
愿效黄牛力	尽抒赤子情
月醉杯中酒	梅思画外春
云山添秀色	河海泛春潮
云霞成异彩	梅柳动春风
云霞呈吉日	花柳发韶年
云霞呈锦绣	世纪现风流
云霞出海曙	梅柳渡江春
云霞出海曙	骏马跃关山
云霞开锦绣	草木弄新姿
云霞蓬勃气	梅雀吉祥图
云中熊虎将	天上凤凰儿
芸窗屋绽玉	兰室笔生花
早莺衔福至	喜鹊报春归
泽雨千山翠	东风万树红
崭然新世纪	伟哉大中华
贞刚直有质	事业无穷年
政策威力大	改革舞台宽
政洁民心悦	官廉国运昌
政廉德载德	官清万口碑
政廉人心暖	法严国运昌
政廉四海乐	春暖百花香
政清人觉晓	春媚燕知归
政善江山稳	官廉气象新
政善民心顺	国强世道安
政善山河美	天清日月明
政通千家福	人和万户春
政通天降宝	人勤地生金
枝头叠梅影	日下有鹊声
枝头沾春露	门户洽清风
知廉标五德	报午必三鸣
志高人勤奋	民安国富强
制律千秋策	守法万民心
治国施良策	改革育英才
中国燃圣火	大地显龙威
中华扬赤帜	壮志步青云
中华扬特色	大地溢春晖
中天悬丽日	大地耀金辉
重教方治国	育才可兴邦
周围云彩丽	五色月华新
猪为六畜首	农乃百业基
竹梅呈秀色	莺燕传佳音
竹影摇风雨	花溪入画图
撰联歌大治	赋诗颂小康
壮怀鸿鹄志	描绘富强图
壮丽关山月	风流世纪春
壮士喜骏马	红花爱英雄
壮芽破肥土	嫩叶迎朝阳
酌酒人陪客	迎春月倚楼
子年春到户	鼠岁喜临门
子时春意闹	鼠岁笑声甜
子时岁交替	鼠节春更新
子为地支首	鼠乃生肖先
子夜松涛劲	鼠年鹊语香
子夜岁交替	鼠年春更新
子夜钟声响	鼠年爆竹喧
紫气腾千里	红旗灿九天
紫燕舞翠柳	黄莺歌红梅
紫燕衔泥舞	黄莺绕树歌
紫燕寻旧主	金牛舞新春
祖国春常在	人民福无疆
祖国春如海	人民力胜天
祖国江山固	人民日月长
祖国开新纪	人民步小康
祖国期大统	人民盼团圆
祖国山河壮	侨乡气象新
祖国兴特色	人民乐小康
祖国臻强盛	人民亨太平
春风吹腐浊	瑞雪兆丰年
春风吹绿树	岁辞花炮里
春风催快马	时雨唤勤农
春风催万物	新雨润百花
春风动百草	兰惠生我篱
春风发万卉	丽日照千门
春风翻雪浪	炉火荡金波
春风芳草地	瑞雨杏花天
春风拂帘幔	瑞气接楼台
春风拂柳绿	喜雨润桃红
春风拂绿柳	灵鼠跳松青
春风拂绿柳	细雨润桃花
春风拂禹甸	政策暖人心
春风含绿意	旭日仰红旗
春风辉德里	淑气霭华堂
春风开玉宇	紫燕筑新巢
春风来海上	明月在江头
春风绿万里	党恩泽九州
春风暖大地	光明照中华
春风暖大地	政策合人心
春风暖大地	江山红万年
春风暖大地	喜雨泽神州
春风暖四海	正气盈九州
春风轻梳柳	夜雨细润花
春风荣草木	红日壮河山
春风荣草木	瑞雪润河山
春风荣国色	公德壮民魂
春风荣胜纪	泽雨润丰田
春风书喜字	彩笔点桃红
春风舒冻柳	瑞雪兆丰年
春风舒柳眼	时雨润桃腮
春风苏大地	新政暖神州
春风苏大地	时雨润神州
春风苏大地	旭日耀寰瀛
春风苏大地	丽日暖人心
春风苏海峡	时雨润山川
春风苏绿野	细雨醒红梅
春风苏万物	细雨绿千山
春风苏万物	喜雨乐千家
春风苏万物	旭日暖千家
春风苏万物	时雨翠千山
春风随处好	世纪及时新
春风随日至	景象逐时新
春风添画意	岁月赋诗情
春风携福至	伟业伴龙腾
春风新燕子	香月古梅花
春风薰四海	德政惠三江
春风摇翡翠	草木吐芬芳
春风引紫气	大地发清华
春风迎顾客	淑气溢商场
春风迎新岁	瑞雪兆丰年
春风盈大地	喜气满人间
春风追丽日	羊角步青云
春拂芬芳地	马奔锦绣程
春官桃李长	昭代岁时新
春光遍草木	佳气满山川
春光处处美	节日家家欢
春光辉大地	特色壮中华
春光回大地	和气到人间
春光回大地	喜气到人间
春光明盛世	捷报漫神州
春光洒万里	瑞雪映千家
春光腾四野	捷报喧九州
春光腾紫气	壮志展宏图
春光添异彩	科技改乾坤
春光投富户	喜色入重门
春光无限好	世纪焕然新
春光杨柳绿	国色牡丹香
春归飞雪外	诗就绽梅时
春归黄土地	鸟唱艳阳天
春归杨柳上	燕舞人心间
春和人贺岁	政善福盈门
春花含笑意	爆竹播欢声
春花香四野	德政暖千家
春花香庭院	喜鹊唱枝头
春晖满庭院	欢乐溢门窗
春晖盈大地	正气满乾坤
春辉遍草木	佳气满山城
春降千门福	花开万户欢
春来敦孝悌	节庆品诗联
春来花气盛	时霁鸟声繁
春来花如锦	风过竹自吟
春来柳亦醉	日出花更香
春来千里翠	雨过九霄晴
春来千枝秀	冬去万木苏
春来瑞雪里	人在画图中
春来山水秀	马跃路途宽
春来羊起舞	雪化马归山
春来杨绽绿	霓散日喷金
春来紫燕舞	节到黄牛忙
春丽牛逢草	月明马识途
春联耀春光	喜报传喜讯
春联盈喜气	美酒助豪情
春临花带露	福到院生辉
春满长征路	花繁民主枝
春满人世间	日照大旗红
春明花富贵	风静竹平安
春浓催四化	日暖励长征
春浓花似海	世盛歌如潮
春浓随意绿	花好自然红
春暖百花艳	人勤万物丰
春暖观龙变	秋高听鹿鸣
春暖九州愿	月圆两岸情
春暖千山秀	官清百姓亲
春暖青牛跃	山高碧水流
春暖群芳喜	风清百鸟鸣
春情寄柳色	日影泛桃烟
春情寄柳色	日影泛槐烟
春染千顷绿	花开万朵红
春染乾坤绿	旗开日月红
春染万花蕊	风香两岸人
春日暖大地	光明照中华
春荣新世纪	光耀大中华
春融芳草地	日丽艳阳天
春色临关尽	黄云出塞多
春色绿千里	马蹄香万家
春色千畴绿	旗帜万里红
春色戏新燕	韶光催早花
春时勤百倍	节日俭十分
春水鸣禽韵	康民乐年华
春水千溪绿	神州万里红
春随人意至	福自党恩来
春为一岁首	梅在百花先
春为一岁首	梅占百花魁
春新门载福	志远马扬蹄
春新牛得草	世盛国幅辉
春新羊得草	世盛马加鞭
春信梅花发	秋风桂子香
春醒三冬草	雪开万里晴
春燕鸣暖树	金鼠跳青松
春意及时绿	福音随处留
春意随人意	歌潮逐心潮
春映三江绿	梅开五岳红
春雨润田野	党恩泽庶民
春雨添新韵	东风不白头
春雨新龙角	秋风振凤毛
春云山对屋	夜雨水平桥
春早人尤早	花红心更红
春早水流韵	岁新梅吐香
春早田园秀	世清山水明
春占红梅上	莺歌绿柳前
此间浑是锦	到处尽如春
催春布谷叫	报喜牵牛开
翠湖满湖翠	春江一江春
村村奔富路	户户达小康
村镇融融乐	城乡处处新
大地春风劲	长征战鼓催
大地春光好	神州气象新
大地风雷荡	中华日月新
大地逢春绿	江山映日红
大地千山秀	神州万象新
大地迎春绿	人心向阳红
大富千家乐	小康万户欢
大会惊中外	神州震月星
大业宏图展	新春好运来
大治固家盛	小康岁月甜
大治民心快	小康社会安
丹桂香千里	松柏青万年
丹心辉赤日	黑手献乌金
丹心献祖国	妙手绘春光
丹心珍晚节	白首树新风
淡浓随意变	深浅入时新
党布翻番景	民吟改革诗
党恩深似海	民意重如山
党恩泽四海	政绩炳千秋
党风清如水	国色灿若霞
党正民心乐	官清国运昌
党指通天路	民怀报国心
党指小康路	民歌大有年
党指幸福路	勤开致富门
道德崇高事	风云浩荡春
德风熏赤县	法雨润苍生
德高人寿永	福依党恩生
德门春不老	佳宅福长存
德门增百福	农户驻三阳
灯照千门喜	春暖万人心
笛弄红梅颂	莺歌绿柳春
笛弄梅花曲	莺啼杨柳风
笛奏梅花曲	莺歌杨柳风
地暖花长发	村幽鸟任歌
地暖花长发	林幽鸟任歌
地暖花长发	天晴鸟争鸣
地暖花更发	林幽鸟欢歌
地载风流世	天开锦绣春
丁年歌盛世	卯兔耀中华
东风遍天下	春色满人间
东风传紫气	大地发春华
东风拂大地	政策暖人心
东风舒柳眼	时雨沐春容
东风引紫气	大地发春华
东风迎新岁	瑞雪兆丰年
东南花艳艳	西北兴欣欣
冬去留诗意	春来绘画图
冬随捷报去	春带凯歌来
栋梁砥华夏	桃李芳九州
斗雪梅先吐	含烟柳尚青
读书真福乐	赏画悦心神
端月初临福	新年又报祥
对此文明世	联斯翰墨家
对酒歌盛世	举杯庆升平
对酒歌盛世	举杯庆丰收
对韵俨龙马	联书大吉羊
多才因博学	精艺自超群
发家勤为本	致富俭当头
法为邦命脉	民是业根基
法正江山固	国强世纪娇
法制安天下	科教振中华
反腐扬正气	倡廉树新风
芳草连天碧	春花遍地红
芳草年年发	古城日日新
芳草年年绿	红旗处处飘
芳草年年绿	春联处处新
芳菲春草绿	烂漫山花红
芳树笼秦栈	春流绕蜀城
芳随春意满	年共物华增
放飞新希望	珍惜好年华
放歌迎盛世	酌酒贺新年
放怀歌盛世	泼墨颂新春
飞雪迎春到	高歌动地吟
飞雪迎春到	心潮逐浪高
丰年呈喜报	盛世拓财源
丰年飞瑞雪	好景舞春风
丰年飞瑞雪	骏马跃长征
丰稔黄牛志	富强赤子心
风度竹流韵	马驰春作声
风鼓帆展翼	雨洗山更颜
风光行处好	春色望中新
风光逐时好	春色一番新
风和催四化	政洽喜千家
风和千树茂	雨润百花香
风和日华丽	气澄天宇高
风华新世纪	法制好江山
风幻西欧浊	浪平海峡宽
风劲红旗舞	世新玉宇清
风景神奇秘	文章点缀明
风来花似笑	春到鸟亦歌
风来花自舞	春到鸟能言
风暖日光丽	气清天宇高
风暖日华丽	气澄天宇高
风清春不老	谷聚岁常丰
风清江水碧	政善众心红
风清民乐业	政善众安居
风移兰气入	春逐鸟声来
风引奇香入	祥征景福来
风雨沧桑世	神州浩荡春
风正民心顺	人和国自安
风正民心顺	人和国运昌
风正民心顺	官清社稷安
风正民心顺	人和国事安
风正人民乐	心齐事业兴
国光辉特色	民志展雄风
国华光汉宇	和气煦神州
国华光盛世	民意洽东风
国华光夏甸	民气煦春阳
国家凭法制	世纪灿春光
国家行善政	民众享康宁
国脉千秋在	江河万古流
国强民乐业	春暖燕争归
国强千秋盛	家和万事兴
国强喜事多	民富烦恼少
国盛人民富	家和事业昌
国泰家家福	民安处处春
国泰千秋乐	家和万事兴
国泰千乡富	家和万事兴
国兴凭党领	家治赖人和
国愿人民富	家盼子孙贤
国运逢春好	民心向党红
国肇三阳泰	楼收万里春
国振凭国策	家兴靠家风
国治春光暖	家和鹊声高
国壮山河秀	城春草木新
海阔凭鱼跃	路遥任马驰
海深千水绿	春满万山红
亥时看入户	猪岁喜盈门
寒堆阴岭雪	春泮水池冰
寒风随岁去	德政伴春来
寒尽桃花嫩	春归柳叶新
寒梅浮冷艳	老柳展新姿
寒梅荣盛世	瑞雪兆丰年
寒梅因雪艳	飞燕为春归
寒去草先翠	春来花最红
寒雪催春早	酒香贺岁归
寒雪梅中尽	春风柳上归
豪情歌四化	捷报耀三春
豪饮团圆酒	狂歌幸福年
好景动人处	春风得意时
好景年年好	新春岁岁新
和飞氤氲合	卿云烂漫浮
和风吹绿柳	时雨润春苗
和风动淑气	老树发新枝
和风千日暖	丽景百花妍
和风梳绿柳	时雨润红棉
和光生柳叶	春色泛桃花
和光生绿叶	春色泛桃花
和平防演变	改革勿松疏
和声鸣盛世	鼓乐庆升平
河清庆有日	海晏乐无垠
河山欣挺秀	祖国庆长春
河山迎春绿	桃李迎日红
横心走富路	阔步奔小康
弘扬主弦律	倡导好精神
红点桃花嫩	青描柳色新
红花香千里	春风暖万家
红花映喜报	绿水织春光
红鸡啼夜晓	黄犬吠年丰
红联歌盛世	美酒祝华年
红梅报新春	瑞雪兆丰年
红梅开盛世	瑞雪兆丰年
红梅开岁首	喜鹊唱枝头
红梅香小院	玉兔下人间
红梅香雪海	绿柳笑春风
红梅迎春笑	玉兔出月欢
红梅迎春笑	金葵向日开
红梅迎岁笑	玉兔伴娥欢
红梅迎雪放	玉兔踏春来
红梅赠马岁	彩烛耀羊年
红梅知春早	松柏认岁寒
红旗开玉局	伟业壮金瓯
红旗飘海上	渔歌庆丰年
红旗舞天半	春色满寰中
红旗映喜报	绿水绘春光
红旗招四化	紫燕报三春
红旗昭盛世	紫燕舞春风
红日千秋照	神州万载春
红日驱妖雾	东风扫残云
红日浴林海	万户梅花红
红日照大地	春风拂残云
红松添新枝	青梅映彩霞
红雨桃千树	春风柳十围
红烛陶至美	雏凤育新声
宏图惊虎豹	正气挟风雷
猴引康庄道	鸡迎锦绣春
虎去威犹在	兔来运更昌
虎去雄风在	兔来喜气浓
虎声传捷报	兔影抖春晖
虎威惊盛世	兔翰绘新春
虎啸风声远	龙腾海浪高
虎啸青山秀	兔奔碧野宽
虎跃前程去	兔携好运来
户户春光美	村村气象新
花动朱楼雪	城凝碧树烟
花繁红影碎	叶密绿阴青
花放山河丽	光照天地新
花开春富贵	竹报岁平安
花开春富贵	竹报岁吉祥
花开天下福	马跃人间春
花开万里香	日出千山丽
花開朝日地	富致勤俭家
花木四时秀	庭院满眼春
傲骨高风亮节	红梅翠竹青松
白发同偕千岁	红心共映春秋
白雪红梅报喜	黄莺紫燕迎春
百花生香吐艳	四化跃马扬鞭
百花生香吐艳	四化跃马争春
百花迎春斗艳	群英为国争光
百卉近春斗艳	群芳为国争光
百卉迎春斗艳	群芳为国争荣
百联同歌盛世	九州共祝民康
百族家家乐业	九州户户安居
爆竹声声除旧	桃符代代更新
爆竹声声祝福	灯花闪闪迎春
爆竹一声除旧	桃符万户更新
爆竹一声除旧	春联万户更新
爆竹一声辞旧	桃符万户更新
北京赢来奥运	中国获得成功
碧海苍山玉宇	春风丽日神州
鞭炮声声报喜	红灯盏盏迎春
表演神州好事	传播时代精神
不靠苍天赐福	全凭白手起家
彩笔精描四化	红心巧绣三春
承上下求索志	绘春秋振兴图
除旧岁破旧俗	迎新年树新风
处处春光济美	年年人物风流
处处欢歌遍地	家家喜笑连天
处处明山秀水	家家笑语欢歌
窗外红梅最艳	心头美景尤佳
创造万千气象	建设两个文明
春草满庭吐秀	百花遍地飘香
春到碧桃树上	莺歌绿柳楼前
春到芙蓉国里	福临杨柳门前
春到红鬃马上	喜临绿柳门前
春到江南塞北	马腾正气清风
春风吹遍天涯	阳光普照人间
春风春雨春花	新年新岁新景
春风春雨春色	新岁新年新风
春风春雨春色	新年新岁新景
春风花香鸟语	夜月书韵琴声
春光洒满大地	彩霞映遍神州
春好群芳共喜	禾丰举国共欢
春来花香鸟语	雪兆五谷丰登
春来鸟语花香	冬去山明水秀
春满勤劳门第	喜融幸福人家
春满三江四海	喜盈万户千家
春暖风和日丽	年丰物阜民欢
春暖风和日丽	物丰国泰民安
春暖风和日丽	政兴人寿年丰
春暖风和日丽	年丰物阜民康
春日人人共乐	江山处处皆春
春意布满大地	阳光普照人间
春引百花竟放	福到人寿年丰
春织千山锦绣	旗扬万里雄风
春至家中抽芽	福从天上降临
春种遍地绿玉	秋收满仓黄金
春种千山绿玉	秋收万顷黄金
春种千田碧玉	秋收万仓黄金
春驻笔花万朵	云描淑景千番
春著笔花万朵	泰蒸豹雾千层
春自改革唤起	富由开放得来
春自寒梅报到	年从瑞雪迎来
春自寒梅报起	年从玉兔迎来
春自寒梅唤起	香由乳燕衔来
春自卯时报起	福由兔口衔来
翠竹红梅青松	傲骨高风亮节
大地百花齐放	神州万象更新
大地风光旖旎	神州人物轩昂
大地三春永驻	神州两制长存
大地生香吐艳	神州跃马争春
大水流为九曲	春风又是一年
大业千帆竞发	明春万象更新
荡荡乾坤不老	昭昭日月生辉
到处山欢海笑	遍地虎跃龙腾
地灵更喜人杰	物阜又遇年丰
电信九州枢纽	邮局四化桥梁
冬尽梅花点点	春回爆竹声声
冬去山明水秀	春来鸟语花香
冬去山青水秀	春来鸟语花香
冬去山青水秀	春来燕舞莺歌
杜宇一声春晓	黄莺几啭岁新
发家切记勤俭	富裕莫忘扶贫
法制成风国泰	道德化雨民安
反映时代脉搏	振奋民族精神
芳草遍地吐秀	群英满园生香
芳草满园吐秀	群英遍地生辉
放眼崭新世纪	振兴锦绣中华
飞雪片片凝瑞	马蹄声声报春
奋扫山间雨露	喜迎天下宾朋
风过红旗似画	春来绿水如烟
风景这边独好	江山如此多娇
风展红旗如画	春来众志成城
风展红旗似画	春来绿水如蓝
风正江山吐秀	心齐国运昌隆
福临寿星门第	春到致富人家
福满工农门第	春到劳动人家
福日九州共乐	新年四海同春
富裕全凭奋斗	成功来自艰辛
改革潮掀巨浪	振兴气贯长虹
改革顿开富路	承包立铲穷根
港澳归帆在望	台澎去雁将回
港澳荣归故国	炎黄喜步登天
歌颂轩辕功德	弘扬民族精神
功业长留天地	光辉永照人间
共建文明环境	同兴锦绣中华
共庆春回大地	同歌喜到人间
共喜阳回大地	同歌春到人间
国富民强盛世	花香日暖新春
国富民强世盛	天时地利人和
国富星辰耀彩	政清日月生辉
国贵安定团结	家宜勤俭节约
国际风云多变	神州信念益坚
国强家富人寿	花好月圆年丰
国泰家兴民乐	年丰日富时昌
国肇繁荣昌盛	民欣长治久安
好山好水好景	新岁新春新人
好水好山好景	新岁新居新人
何限我家富裕	更求全国繁荣
和睦聚财致富	忠厚多福永安
红梅初绽花二	东方风来又一
红梅伸枝傲雪	桃李含笑迎春
红梅铮骨傲雪	桃李笑颜迎春
红心巧绘三春	彩笔精描四化
红杏香满晴陌	青梅酸滴阳枝
虎奋千年古国	龙腾四化鹏程
虎去犹存猛劲	兔来更显奇才
虎去犹留猛劲	兔来更显捷才
虎啸凯歌一曲	兔奔喜报九州
虎跃龙腾碧海	莺歌燕舞春风
虎跃龙腾国瑞	春华秋实年丰
虎跃龙骧鹏举	天时地利人和
虎跃龙骧鹏举	花明柳暗春浓
户户金花报喜	家家紫燕迎春
花艳春光无限	人勤幸福有期
华夏政通人杰	神州长治久安
欢歌笑语辞旧	爆竹花灯迎新
欢歌笑语辞旧	爆竹华灯迎新
欢炮声声报喜	红联对对迎春
欢庆高居大厦	喜迁遥念亲人
火树银花盛景	红梅绿柳新春
加强法制观念	发扬民主精神
家富国强民乐	春浓日暖花香
家家恭喜致富	人人庆贺安康
家家喜迎新纪	处处恭贺丰年
坚持团结奋斗	致力振兴中华
江山春色娇艳	祖国前程辉煌
江山千秋永固	大业百世其昌
江山万里皆春	祖国前程似锦
娇梅傲雪烂漫	嫩柳迎春多姿
节日人人共乐	江山处处皆春
借问春从何至	皆言福自群生
今日千家辞旧	明朝万户更新
景历风花雪月	岁迎春夏秋冬
景美年丰国瑞	春新日丽人欢
静坐常思己过	闲谈莫论人非
九域春光永驻	三江福水长流
九域同歌盛世	七音共庆丰年
旧岁悉除旧弊	新春大树新风
骏马秋风蓟北	杏花春雨江南
骏马四蹄击鼓	羚羊双角开春
开创千秋大业	绘成四化宏图
开拓路上春丽	改革枝头花繁
开拓路途春丽	革新枝上花荣
堪喜风光胜旧	欣逢世纪更新
孔雀开屏报喜	画眉欢唱迎春
孔雀开屏献美	画眉欢歌迎春
劳动创出世界	国家属于人民
乐看四化伟业	喜听八方春音
历尽酸甜苦辣	迎来洒脱风流
立志当怀虎胆	求知莫畏羊肠
丽水丽山丽景	新春新岁新人
两岸春光普照	千家瑞气盈门
两岸同期一统	九州共乐三春
两袖清风门第	四时和气人家
领略神州风采	颂吟改革华章
留下小龙胜景	迎来骏马新春
柳色年年相似	世态岁岁更新
柳下清琴皓月	花前益鸟春风
六合和平博爱	三江富裕常宁
龙腾千年华夏	蛇舞世纪新春
马去抬头见喜	羊来举步生风
马岁家家如意	羊年事事吉祥
马岁增添马劲	新年再绘新图
马啸英雄浩气	羊鸣世纪春光
满户晴光瑞气	一门福寿安康
梅报九州春色	旗开一代风流
梅蕊乐开五福	竹风喜报三多
美化金瓯壮丽	高悬玉镜光明
门畔山青水秀	院中鸟语花香
描绘千秋伟业	腾飞万里鹏程
描绘神奇世界	歌吟曲折人生
描绘中华特色	放飞大地春光
妙手描山绣水	雄心强国富民
民族昌盛富强	祖国兴旺发达
民族精神不老	英雄本色升华
默默无闻做事	孜孜不倦读书
能者当家家福	腊梅报岁岁丰
年丰德茂福盛	家旺国兴人和
年丰人寿福满	鸟语花香春浓
年丰人寿福满	柳绿花香春浓
年年柳色相似	岁岁世态更新
品蛰逢雷欲奋	盘根久冻春回
千仞峦峰皆秀	万里江河竞流
千乡同歌国盛	万民共庆年丰
前程千帆竞发	盛世万象更新
前程绚丽似锦	好景明媚如春
前程绚丽似锦	好景明丽如春
勤创九州伟业	诚招四海英才
勤劳千载致福	和睦家庭幸福
勤乃发家妙策	俭为致富良方
勤探知识大海	勇攀科学高峰
庆幸一元夏始	祝福万户更新
犬吠佞人丧胆	鸡鸣玉宇生辉
人靠勤劳致富	家因和睦生财
人勤六畜兴旺	智多五谷丰登
人寿国强家富	年丰花好月圆
人寿年丰福满	花香柳绿春浓
认认真真办事	清清白白做人
日丽风和春暖	党廉政善民安
日丽风和景艳	人欢马叫春新
日丽风和人乐	国强民富年丰
日丽风和雨润	龙腾虎跃霞飞
日暖风调雨顺	家和人寿年丰
日日生财有道	春春纳福无涯
瑞雪娇梅袅柳	新春美酒佳联
瑞雪松涛竹韵	春风鸟语花香
扫除拜金邪气	树立崇德佳风
山碧千峰竞翠	水清百舸争流
山碧千峰竞秀	水清百鸟争春
山青水秀春艳	花好月圆谷香
尚存金蛇灵气	重振龙马精神
设计匠心独运	铸机妙手成春
神州—派春色	祖国无限生机
神州青山不老	祖国红旗永飘
神州万里春风	盛世千秋伟业
升平岁辞戊辰	盛世春迎已巳
盛世民安业壮	神州虎跃龙腾
盛世千秋伟业	神州万里春风
时雨当春乃降	好花应时而开
世纪光华岁月	中华锦绣河山
事事随心称快	家家惬意欢欣
守法才能执政	无私方可当官
守法奉公遵纪	尊长爱幼敬贤
双手创造奇迹	一心夺去丰收
霜送晓寒侵被	笔连墨韵迎晨
水秀山明草茂	羊肥马壮春荣
水秀山青春艳	月圆花好谷香
舜犬重临华夏	犬年大展雄姿
四海旌旗映日	五湖战鼓催春
四化千秋鼎盛	九天万象更新
四化喜开国运	千方共庆家祥
四化蒸蒸日上	五业欣欣向荣
四季时时胜意	千家事事舒心
四序先临首祚	万家同得长春
松下清琴皓月	花边好鸟春风
送走一穷二白	迎来万紫千红
岁岁风调雨顺	年年物阜民康
岁岁三春得意	年年万事开心
缩千里为咫尺	联两地为一家
泰运频书大有	昌期幸际升平
堂前紫燕对语	户外黄莺联鸣
桃符窗花瑞雪	柳浪布谷春风
桃红复含春色	柳绿更带朝烟
桃杏春季争放	杜鹃夏季吐香
提倡五讲四美	建设精神文明
提高医疗质量	增进人民健康
天马横空出世	腊梅傲雪迎春
天启三春美景	人描四化宏图
铁石梅花气概	山川香草风流
铁水奔流报喜	钢花怒放迎春
同心同德建国	克勤克俭持家
万里江山如画	百年世纪长春
万马奔腾贺岁	五羊奋跃迎春
万众共迎旭日	九州同庆新春
为创甜蜜事业	何辞雨露风霜
为江山添秀色	与日月争光辉
唯俭唯勤创业	亦耕亦读传家
乌金黄土故地	白羊绿野新郊
物阜国强民富	天时地利人和
喜报英雄门第	春到光荣人家
喜报英雄门第	春归光荣人家
喜报英雄门第	春临光荣人家
喜爆声声报岁	红灯盏盏迎春
喜创千秋大业	殷期万众小康
喜看春光普照	笑迎泰运频来
喜纳工农雅意	精描马列宏图
喜鹊登枝祝福	灵羊及地呈祥
喜盈工农门第	春满劳动人家
细雨无声润物	和风会意迎春
显现英雄本色	顺应时代潮流
香梅含苞怒放	瑞雪吐絮迎春
笑问春归何处	喜看水绿江南
笑盈盈辞旧岁	喜滋滋迎新春
笑语欢歌辞旧	华灯爆竹迎新
心似春花怒放	财如瑞雪翻飞
欣看四化伟业	喜闻八方佳音
新岁新光新景	春风春雨春花
胸有春秋全史	目无魏吴群雄
旭日横空出世	腊梅做雪迎春
悬鱼流芳百世	纳贿遗臭万年
雪白梅红柳绿	政通世顺人和
雪片纷纷凝瑞	马蹄得得报春
雪瑞年丰福满	人欢马叫春浓
雪映梅花更艳	春归柳色尤青
雪映一天春碧	云浮四海清晖
燕雀应思壮志	梅兰珍重年华
燕尾点波绿皱	莺嘴啄花红流
燕子争泥黄坡	人家晒网绿洲
养成勤俭美德	树立俭朴新风
一刻莫闲岁月	十分珍重年华
一院芝兰瑞气	万家杨柳春风
亿众赤心向党	万千花朵朝阳
艺苑百花争艳	文坛万象更新
溢彩流光岁月	知书达理人家
迎春丹青焕彩	辞岁翰墨飘香
有竹有梅门第	半村半廓人家
与松竹梅交友	择兰荷菊为邻
雨过青山吐翠	风来碧野飘香
愿为河山添锦	敢与日月争辉
月明五湖曙色	潮满三江春光
月圆常念家国	花好倍思眷亲
阅尽人间春色	领先时代潮流
展现民族特色	弘扬时代精神
珍惜黄金时代	莫负锦绣年华
珍惜青春岁月	追求精彩人生
正正堂堂行事	清清白白作人
政惠九州祥瑞	人和四海康宁
政清山河似锦	国富岁月如花
政清星辰耀彩	国富日月增辉
致富条条是道	国强步步登天
种养择优发展	产销配套成龙
竹报一元复始	花开四化初成
竹露松风蕉雨	清茶琴韵书生
壮志五湖四海	春光一刻千金
子岁先登富路	丑年再上新阶
紫燕黄莺布谷	红梅绿柳迎春
祖国繁荣昌盛	人民福寿安康
祖国风光绚丽	人民福寿安宁
祖国河山竞秀	人民天下长春
祖国河山似锦	神州大地皆春
祖国江山如画	人民事业同春
祖国前程无量	人民奋发有为
祖国山河壮美	神州春意盎然
祖国山明水秀	中华人杰地灵
祖国山青水秀	中华人杰地灵
祖国与天齐寿	人民同地永宁
最喜年春并至	堪欣福寿同增
最幸春光有主	还欣瑞气无边
昨夜彩云追月	今朝爆竹迎春
昨夜春风入户	今朝喜气盈门
爱幼尊翁中华美德	和邻睦里社会新风
安定团结人心所向	正本清源国运必兴
百年大计树人为本	万里长征立志当先
百业兴昌欣逢盛世	万民愉悦喜接新年
柏叶为铭椒花献瑞	龙缠肇岁凤纪书元
邦兴国治鸡唱门庭	春暖花开犬蹲院里
宝地祥光开泰鸿运	天时地利门庭大吉
宝地钟秀年丰物阜	圣哲通灵人慧德清
爆竹梅花有声有色	金戈铁马无虑无忧
爆竹千声同辞旧岁	梅花一点独报新春
爆竹声声红梅点点	莺歌阵阵绿柳悠悠
爆竹声声普天同庆	金鼓咚咚万众欢腾
爆竹声中百花竞艳	红旗飘处万象更新
爆竹数声花明柳媚	春风一度雪化冰融
爆竹送走一穷二白	春风迎来万紫千红
北斗光明春台起凤	南溟壮阔羊角搏鹏
北国南疆八方锦绣	东桃西桂四季芬芳
蓓蕾初绽一年伊始	芳草新萌四季长春
比勤赛富千家盈喜	迎春接福万户纳祥
碧草白羊三春图画	金戈铁马万里征途
碧杨垂岸莺歌燕语	红杏出墙蝶舞蜂忙
璧合金瓯神州焕彩	龙腾玉宇世纪更新
边疆儿女胸怀祖国	各族人民心向北京
鞭炮声声高歌幸福	春联幅幅恭贺新年
丙穴鱼生人间改岁	寅方斗指天下皆春
不知索取只知奉献	勿问收获但问耕耘
布谷鸣春人勤物阜	瑞狮舞彩国富年丰
策马行空与时俱进	还羊务实举国小康
姹紫嫣红五湖春满	安居乐业十亿民康
长城雄姿松柏体魄	钢铁意志龙马精神
长春树独茂勤劳第	幸福花只开和睦家
乘东风踏平万里浪	扬海螺威震九重天
乘风扬帆渔歌腾浪	归舟破浪锦鳞满仓
赤帜拂天日新月异	青松拔地人寿年丰
除恶惩贪祛邪扶正	兴廉反腐激浊扬清
除夕立春同日双庆	随时进步一刻千金
处处春风花开富贵	家家笑语礼尚文明
春蚕织成满园锦绣	红烛点燃一代心灵
春催神州百花争艳	光耀华夏群龙竞飞
春到神州百花吐艳	香飘原野万物生辉
春风吹暖英雄门第	喜报映红光荣人家
春风春雨春花灿灿	喜酒喜歌喜气洋洋
春风春雨春色灿烂	新年新岁新景辉煌
春风春雨风调雨顺	爱国爱民国泰民安
春风春雨宜人春色	新人新事治事新风
春风得意马驰千里	煦日扬辉光照万家
春风得意马驰千里	旭日扬辉光照万家
春风浩荡花香鸟语	岁月峥嵘虎跃龙腾
春风化春雨添春色	新年树新风出新人
春风送暖百花争妍	瑞气迎祥万物生辉
挑重担心怀千里志	顾大局胸有一盘棋
铁面无私一身正气	秉公执法两袖清风
同心同德宏图再展	群策群力快马加鞭
兔腾大地清辉万里	龙舞长空捷报千传
兔跃蟾宫更新世纪	龙巡禹甸布福乾坤
推剪刮剃使您满意	烫吹洗理令尔称心
吞云吐雾金龙崛起	展志舒情彩凤腾飞
脱贫致富科学引路	改地换天技术当先
万户春风礼陶乐淑	三阳景运人寿年丰
万里春风峥嵘岁月	一庭瑞雪抖擞精神
万里蓝天群星灿烂	九州大地百业繁荣
万象更新精神奋发	百花齐放春满人间
万象更新山青水秀	五羊献瑞日丽春华
万象更新无山不秀	一元复始有水皆清
万众一心排山倒海	全民协力改地换天
万紫千红百花齐放	三江四海五谷丰登
万紫千红百花争艳	五湖四海一体同春
万紫千红满园春色	五讲四美遍地新风
望天宇八方清似玉	喜人间四季暖如春
为民办事一尘不染	替众分忧两袖清风
为人师表诲而不倦	替国树才教必有方
伟大祖国蒸蒸日上	锦绣河山欣欣向荣
文明巷陌和衷共济	道德邻居风雨同舟
五环辉映奥梦圆满	十亿激昂国魂壮威
五羊献瑞江天溢彩	百凤朝阳岁月流金
五岳峥嵘雄狮奋起	九州激荡巨龙腾飞
物阜年丰春临大地	山欢水笑气贯长虹
喜报吉祥辉煌灯火	春风和煦勤奋人家
喜看大地莺歌燕舞	笑迎农家马壮牛欢
喜气光临警察门庭	鲜花开在光荣人家
喜庆新春闻鸡起舞	欣逢盛世跃马扬鞭
喜盈门天乐人亦乐	春及第马驰志也驰
喜盈门天乐人亦乐	春及第花开心亦开
喜盈四海山河巨变	花漫九州岁月更新
细雨和风田园景色	青山绿水诗画农家
贤明治世广施德惠	科教兴邦独领风骚
香港归宗风和日丽	神州雪耻水笑山欢
香港归宗普天共庆	陆台联袂两岸同心
香港回归金汤永固	中华崛起玉宇澄清
香港回归山河竞秀	中华崛起大地争辉
香水流香年年献瑞	港人治港事事呈祥
祥光普照百花添艳	福地回春万物更新
祥瑞迎门乐无止境	牛羊满圈喜不胜收
祥云兆日舒心盛世	芳草迎春如意年华
小康富路风光无限	大治宏图春色满园
笑舞东风松梅竞秀	喜沾春雨桃李争妍
辛岁迎春流金溢彩	巳年跨纪策马扬鞭
新来世纪这般美好	故有江山如此多娇
新世纪江山腾锦绣	大中华事业竞辉煌
新岁开头抬头见喜	履端迈步动步生财
新岁新居喜出望外	故人故地乐在其中
新岁新人新歌盈耳	春风春雨春色满园
新中国跨上千里马	众英毫描绘四化图
杏花村里香飘四海	竹叶杯中甜溢五洲
幸福家庭丰衣足食	文明社会正气清风
幸福家庭幸福美景	文明社会文明新风
旭日东升一元复始	鸿图大展万象更新
旭日蓝图豪情壮志	春风时雨泽国惠民
旭日祥云千门竞盛	春风化雨万物争荣
旭日扬辉普天同庆	东风解冻大地皆春
旭日永临文明门第	春风常驻勤俭人家
选贤任能维才是举	励精图治振兴在望
学无止境发挥余热	老有所为报答党恩
雪满千岩山高月小	春来万里水流花开
雪飘故里人财两旺	日暖新居福寿双全
言谈和气热情似火	举止文明欢笑如春
燕舞莺歌喜盈在地	桃欢李笑春满校园
羊欢马跃山川易旧	燕舞莺歌岁月更新
阳春美景山河绚丽	大块文章岁月增新
一代风流九州生色	八方锦绣四季呈祥
一代英豪九州生色	八方捷报四季呈祥
一国两制同迎佳节	四海五湖共贺新春
一纪开端共迎金鼠	三春肇始同举玉杯
一九九九民欢国庆	二零零零虎跃龙腾
一派生机阳春映日	满天焕彩浩气腾云
一派生机阳春有脚	满天异彩浩气腾胸
一身正气与民造福	两袖清风为国争光
一县芳名贾商似海	三江春水福寿如潮
一夜报春百花齐放	三阳开道万马奔腾
乙木逢春枝繁叶茂	丑牛得草体壮膘肥
以念佛心证无生忍	将净土教度有缘人
溢彩流金河山似锦	穿红着绿岁月如花
迎新春盼江山一统	送旧岁期骨肉重圆
迎新春应赞猪为宝	辞旧岁莫忘犬看家
迎新年窗花映白雪	辞旧岁喜鹊闹红梅
迎羊送马百花锦簇	起凤腾蛟万代繁荣
拥政爱民丹心似火	兴邦报国壮志凌云
有勇才能降龙伏虎	无私方可扶正驱邪
雨露无私桃红柳绿	河山有主物阜民康
雨顺风调年丰物阜	政廉策善世盛业新
玉凤还巢年丰物阜	金龙起舞国富民殷
玉兔出行满天春色	山君归隐一路雄风
玉燕嬉春九州铺锦	金猴贺岁一国呈祥
玉宇澄清九州日丽	东风浩荡四化春新
玉宇气清鹰冲霄汉	神州春暖鲤跃龙门
育李培桃香飘万里	树人立国功著千秋
—元复始九州同庆	八方和协四季平安
月圆花好鸟飞鱼跃	雨顺风调马壮人欢
一轮红日千秋永照	四化蓝图万众同描
跃马迎春春风扑面	抬头见喜喜气盈门
云涌吉祥风吹和顺	花开如意竹报平安
载酒迎春春光丽丽	出门见喜喜气洋洋
泽被神州风调雨顺	安居乐土物阜年丰
宅边屋角瓜黄菜绿	池间河畔鸭大鹅肥
战地斗天勤能致富	节衣缩食俭可养廉
招手迎春春风拂面	抬头见喜喜气盈门
珍惜海晏河清盛世	描绘国强民富宏图
真为生死发菩提心	以深信愿持佛名号
枕戈待旦心存岗哨	戴月披星志在山河
振兴中华千帆竞发	建设祖国万众争先
政惠千家前程似锦	人和百族暖意如春
政民合手同织锦锈	天地齐声共唱繁荣
政善人和百业兴旺	风调雨顺五谷丰盈
政通人和百废俱举	风调雨顺万象更新
政通人和百废振兴	春暖花开千山呈荣
政通人和家齐国治	风调雨顺物阜民殷
政通人和万家康乐	春华秋实一片繁荣
枝头喜鹊扬眉报喜	雪里春梅翘首迎春
执法秉公清风两袖	从政无私正气一身
植树造林千山叠翠	修渠垒堰万水扬波
植树造林青山不老	修旧改土绿水长流
指点江山春光满目	激扬文字彩笔生花
中华儿女顶天立地	华夏子孙革故鼎新
中华经济一枝独秀	西部辽原万马争雄
中华崛起宏图壮丽	民族振兴大业辉煌
中华崛起山河竞秀	民族振兴日月争辉
重教兴华光弥六合	呕心沥血名振千秋
竹苞松茂青山不老	鱼肥莲香富水长流
筑厦建楼为民造福	添砖加瓦与国增辉
壮丽江山繁花竞放	风云世纪异彩纷呈
壮志凌云红心向党	春风送暖瑞气盈门
紫气冲天物华天宝	阳春吻地人杰地灵
紫气东来江山如画	红旗招展龙虎扬威
紫薇高照三阳开泰	东风劲吹万物咸苏
自力更生愈干愈富	伸手等靠越懒越穷
自主权打通富裕路	责任制架起幸福桥
走万紫千红特色路	发一清二白正经财
祖国大业蒸蒸日上	人民生活步步高升
祖国繁荣江山似锦	东风浩荡大地如春
祖国繁荣日新月异	人民富裕心旷神怡
祖国风光莺歌燕舞	侨乡面貌月异日新
祖国富强神龙活虎	人民幸福舞燕飞莺
祖国欢腾江山一统	澳门豪迈世纪千年
祖国山河频添淑气	炎黄儿女更赴新程
祖国一统人心向往	两岸和平众望所归
春风送暖冰消雪化	细雨传情叶笑花红
春风送暖励精治国	红日增光改革强民
春风送暖千山竞秀	红日生晖百鸟争鸣
春风旭日万里锦绣	瑞气明霞九州升平
春风永绿九州大地	喜气长临五好家庭
春歌春酒春花烂熳	新人新事蔚然成风
春光明媚山青水秀	社稷升平国泰民安
春光无限江山不老	壮志满怀局面常新
春归月殿钟催玉兔	誉满中华鼓舞金龙
春花春雨宜人春色	新事新人治世新风
春回大地百花吐艳	兔跃青山万物生辉
春回大地百花争艳	日暖神州万物生辉
春回大地百花争艳	日照神州万象更新
春回大地金缕溢彩	喜临人间玉雪迎祥
春回大地龙腾虎跃	福满人间莺歌燕舞
春回大地千山竞秀	日暖神州万木争荣
春回大地山欢水笑	日暖神州物阜民丰
春回大地山欢水笑	福满农家人寿年丰
春景宜人百花齐放	东风遍地万象更新
春雷唤醒长城内外	瑞雨淋滋大地东西
春满人间百花吐艳	福临小院四季长安
春鸟声声鸣翠杨柳	联珠串串聚满宝盆
春暖风和花香鸟语	民强国富人寿年丰
春暖花艳千山增秀	政通人和百废俱兴
春色满园春水东流	红杏出墙人寿年丰
春水无形大地自秀	东风有意绿野舒青
春盈岁月心花怒放	福满城乡民气昭苏
春雨遍洒百花吐芳	阳光普照万物生辉
春雨春花宜时景色	新人新事治世高风
春雨润滋前峰竟秀	新风吹拂万象呈辉
春雨晓风花开五色	鼠须麟角力扫千军
春在心头东西自在	人行路上南北皆行
辞旧岁窗花逗紫燕	接新春喜鹊闹红梅
辞旧岁窗花映白雪	迎新年喜鹊闹红梅
辞旧岁革除坏习惯	迎新春描绘新蓝图
辞旧岁共饮幸福酒	迎新春齐绘吉祥图
辞旧岁寒随一夜去	迎新年春逐万里来
辞旧岁家家除旧符	迎新春户户换新桃
辞旧岁九州春日丽	迎新年四海彩云飞
辞旧岁开怀谈国事	迎新春举酒祝丰年
辞旧岁同饮丰收酒	迎新春共庆腾飞年
辞旧岁再创千秋业	过新年更上一层楼
辞旧迎新心花怒放	知难而进金石为开
从勤从俭言行一致	笃志笃学德业双馨
村村富裕家家欢乐	月月称心岁岁丰登
村村美化花盈院落	户户承包果满枝头
大道通天财源滚滚	高楼拔地笑语声声
大地春回凤鸣盛世	中华崛起龙有传人
大地春回江山聚秀	文明运启日月增辉
大地春回山欢水笑	神州日暖物安民康
大地春临多姿多彩	小康福至醉人醉心
大地欢腾春回有意	前程灿烂福来无疆
大地欢腾春回有意	前程广阔日进无疆
大地回春百花争艳	福满人间气象更新
大地回春风光胜昔	山川添秀岁月更新
大地回春九州焕彩	银驹献瑞四季呈祥
大地回春山河壮丽	阳光普照玉宇澄清
大地回春山欢水笑	甘霖沃野柳绿花红
大地新春百花齐放	和风甘雨四季丰收
大海方平千帆竞发	征途正远万马奔腾
大好山川天高地阔	崭新世纪海晏河清
大好神州龙腾虎跃	无边春色凤翥鸾翔
大业中兴宏图再展	神龙起舞祖国长春
大治天下春光永在	翻新山河美景无边
丹凤来仪春回大地	金鸡报晓福满人间
党风端正江山永固	国法严明事业常兴
党风端正人民得福	国法严明天下归心
党建奇功普天同庆	国兴特色遍地皆春
党清国盛泽及千代	政通人和福降万家
党清国盛泽及万代	风正人和福降千家
党如旭日永悬霄汉	民似诸星常拱北辰
党树新风万民愉悦	国兴特色百业昌隆
党心民心心心相印	家事国事事事总成
党政同心社稷永固	干群共济祖国长春
道路畅通车如流水	班组养护人似春风
稻熟粮丰年歌大有	宛宽国裕户庆小康
得甘雨山河增秀色	领新潮日月播春晖
地灵人杰天行丽日	海晏河清户挹春风
地喜天欢锦山秀水	耕耘春图时和岁丰
鼎新革故九州崛起	扶正祛邪万众欢腾
东风浩荡春光似海	政策英明盛世如花
东风浩荡江山如画	祖国繁荣大地皆春
东改西开东西合璧	南招北引南北同舟
东南西北八方吉庆	春夏秋冬四季平安
东西南北八方共舞	春夏秋冬四季同歌
东西南北财源广进	春夏秋冬生意常隆
冬去春来一元复始	云开日丽万象更新
冬去高天万物复苏	春回大地一派生机
冬雪飘飞千门纳福	春潮涌动万象生辉
都摄六根净念相继	高登九品大愿方成
读书莫能春风过耳	开卷确有金玉良言
读万卷书行万里路	持四原则立四化功
对岸人家枕流抱石	此楼风物古木苍岩
发财路通东西南北	文明花开春夏秋冬
法得民意九州春暖	策入人心四海升平
法轮常转佛日增辉	国运兴隆万民齐欢
反腐败敢摸老虎腚	做学问能钻牛角尖
反腐倡廉春风劲发	修文练武国运常新
反腐倡廉风清政善	改革开放国富民殷
反腐倡廉国强民富	保真打假风正业兴
方向明指出康庄道	政策好大开富裕门
芳草鲜花共庆盛世	清山绿水同展新图
飞雪迎春含梅怒放	和风拂地嫩柳舒芽
奋志求成励精图治	与时俱进开拓创新
丰岁盈喜金蛇献瑞	新春扬鞭骏马奋蹄
风调雨顺万象生辉	政善人和百业俱兴
风和日丽百花齐放	人杰地灵万姓皆欢
风和日丽花红叶绿	窗明几净家俗人康
逢盛世更觉国威壮	遏灾年倍感党恩深
扶危济困雪中送炭	保险保安锦上添花
服务周到群众满意	态度和善顾客称心
福慧庄严成无上道	慈悲广大度有缘人
福临华夏三阳开泰	喜报新春四海流金
福鹿吉羊三元开泰	尧天舜日万象更新
福星高照长空溢彩	万事亨通大地流金
福至新年人招好运	门临大喜户入长春
富国富民富歌嘹亮	春山春水春意盎然
富国兴邦人欢财旺	移风易俗地美天新
富国兴家一元复始	改天换地万象更新
富临山寨千峰竞翠	春到茶区万壑飘香
改革创新天天向上	与日俱进日日争辉
改革创新兴家兴业	安定团结利国利民
改革开放国强民富	反腐倡廉地久天长
港澳双归全民共乐	陆台一统举国同欣
革故鼎新重光禹域	尊师重教大振国风
革命精神龙腾虎跃	建设成就日异月新
隔海域盼亲人安好	逢新春祝祖国富强
庚辰呈祥圆世纪梦	辛巳献瑞創新元河
贵门迎财财源广进	吉宅接福福寿无边
滚滚新潮千帆竞发	融融春色万木争荣
国安家泰江山锦绣	人寿年丰天地长春
国逢盛世人勤春早	民乐尧天物阜年丰
国富民强城乡普庆	山青水秀春色多娇
国富民强城乡普庆	山青水秀春色集祥
国富民强普天同庆	山清水秀春色集祥
国富民强千秋壮丽	山欢水笑万物欣荣
国计民生全凭新政	年丰物阜赖有良谋
国强家富诸行兴旺	水碧天蓝幸福久长
国色天香香飘万里	山青水秀秀润千年
国事升平山河壮丽	春风浩荡草木芳菲
国泰民安金汤永固	风调雨顺玉宇常清
国泰民安四化有望	风调雨顺五谷丰登
国泰民安莺歌燕舞	港归澳返璧合珠还
国运宏开不违机遇	蓝图大展再上层楼
国正芳年家图大业	人辞旧岁民乐小康
国祚昌隆日新月异	世风淳朴海晏河清
过佳节方知红日暖	度阳春倍觉党恩深
海晏河清唐虞盛世	莺歌燕舞丽日新天
海晏河清莺歌盛世	云蒸霞蔚燕舞升平
海滟河清龟蛇献寿	风和日丽桃李争春
好雨知时百花齐放	春风得意万马奔腾
河山万里日新月异	神州十亿笑逐颜开
贺新春新人谱新曲	庆佳节佳话联佳姻
红梅报春励精图治	满园桃李天涯芳草
红桃映日和风吻柳	紫燕迎春瑞气呈祥
宏观在宇微观在握	虚心而学实心而行
宏图美景文明社会	绿树红楼幸福人家
虎啸千山声声响应	兔驰万里步步腾飞
虎跃龙腾九州焕彩	风调雨顺五谷丰登
户迎春春桃妆绿柳	门有喜喜鹊闹红梅
护育双兼无山不绿	蓄导并举有水皆清
花果飘香美哉乐土	猴年增色换了人间
花香鸟语人勤春早	风和景明民乐年丰
花盈万里乾坤增色	春满九州日月交辉
华夏龙腾春晖无限	神州虎跃气象万千
华夏腾飞全球刮目	炎黄奋进一体扬眉
华夏中天艳阳高照	勤劳门第紫气东来
画里江山飞花点翠	枝头梅鹊斗艳争春
欢庆新春百花齐放	大办农业五谷丰登
会遇群贤清流趣永	时当乐岁化日春长
惠风远拂神州溢彩	丽日高悬大地生辉
惠政泽民震惊世界	廉风化雨昌盛中华
货架上下繁花似锦	柜台内外笑脸如春
击节欢歌河清海晏	舒眉含笑人面桃花
吉星高照家迎百福	春光辉映户纳千祥
吉星高照勤劳门第	福字常悬改革人家
济困扶贫雪中送炭	增财铺道锦上添花
继往开来鼎新骏业	承前启后蔚起人文
继往开来时迁史进	因材施教石秀花荣
家福人欢顺如流水	时益景顺喜若春风
家家户户欢欢喜喜	水水山山秀秀清清
家家纳福事事吉祥	岁岁迎春年年如意
建功当代江山锦绣	造福黎民岁月辉煌
建设中华日新月异	开发西部水笑山欢
健步攀登年年向上	雄心开拓事事更新
江山万里似诗似画	岁月千秋如火如荼
阶前风暖径外花艳	北榭梅启东涧柳舒
捷报频传喜盈眉宇	凯歌高奏甜进心窝
借才发财财由才出	凭正理政政从正兴
金戈铁马九州生色	玉树银花四海腾欢
金戈铁马扬眉吐气	火树银花浴雪迎春
金猴献礼家家顺利	喜鹊闹春事事吉祥
金蛇献瑞家兴业旺	骏马迎春国富民强
锦绣前程龙腾虎跃	辉煌胜纪燕舞莺歌
锦绣前程千帆竟渡	长征路上万马奔腾
锦绣山河春和世泰	峥嵘岁月马叫人欢
经济上台阶国昌盛	生活奔小康民安乐
净宗即显说之密法	念佛为成佛之捷径
九域同舟民安国泰	八方共济物阜年丰
九州春色竞争红紫	一代新人各领风骚
九州春色莺歌燕舞	四海征程虎跃龙腾
九州大地山欢水笑	万里蓝天日丽风和
救死扶伤丹心献党	消灾祛病妙手回春
桔井泉香杏林春暖	芝田露润蓬岛花浓
举国欢腾神州奏凯	普天同庆香港归宗
举世齐歌人勤春早	万方共庆国富民强
巨斧生辉砍开大地	匠心独运整顿乾坤
俊杰领航神州崛起	人民作主祖国腾飞
骏马辞行喜盈岁月	灵羊献瑞福满乾坤
骏马嘶风九州辞旧	杏花沐雨四海迎新
开发智力共创伟业	繁荣经济再展宏图
开门迎春春光拂面	抬头见喜喜气满堂
开门迎春春回大地	抬头见喜喜满神州
开拓财源春来茂盛	改革经济马到成功
开拓新程云鹏展翅	振兴华夏天骥骋才
靠科学富裕临门早	讲文明春风及第先
靠勤劳拓展政富路	凭知识叩开发财门
科技兴华富民强国	神舟翔宇傲月环球
苦海无边回头是岸	止恶行善作个好人
快马加鞭振兴祖国	闻鸡起舞建设家园
葵花向阳五洲竞放	游子爱国四海同心
腊尽春回风传喜讯	人欢马叫雪兆丰年
劳动致富生活改善	勤俭持家衣食丰足
乐享升平安居盛世	风拂绿柳雪绽红梅
乐奏小康人迎四化	年歌大有春暖千家
礼敬慈尊三身圆现	虔诵佛号万德齐彰
李艳桃红杏坛竞秀	兰馨蕙馥文苑争芳
立志当怀虎胆驰骋	求知莫畏羊肠扶摇
廉洁奉公中华美德	谨勤创业社会新风
两岸三通金蛇起舞	双归一统玉盏飞觞
两袖清风公仆本色	一腔热血赤子情怀
两袖清风造福大众	一身正气振兴中华
两制共存金瓯同庆	五星高照香港荣归
林木成荫无山不绿	沟渠结网有水皆清
柳绿桃红江山如画	冰消雪化天地皆春
龙的传人强邦富国	春之使者润土丰年
龙的传人扬眉吐气	春之使者傲雪朝阳
龙飞凤舞清平盛世	燕语莺歌大地回春
龙凤炳文神州焕彩	鲲鹏展翅华夏腾飞
龙凤呈祥阳春锦绣	鲲鹏展翅华夏腾飞
龙凤呈祥招财进宝	龟蛇献瑞纳福迎春
龙惯飞翔终归大海	蚁虽曲行敢上高峰
龙留喜气喜盈门户	蛇闹春光春满山川
龙鸾炳文神州焕彩	鸿鹏展翅华夏腾飞
龙启吉祥云蒸霞蔚	花开富贵人寿年丰
龙上高天凤翔过树	春盈大地花漫神州
龙腾碧海人间改岁	蛇舞青山大地皆春
龙腾云海凤翔天宇	春满江山花漫神州
龙舞庚辰功勋卓著	蛇荣辛巳岁月光辉
龙钟传技不留一手	老树著花贵有繁枝
陆台一统陆台兴旺	港澳双归港澳繁荣
律启初春观花赏岁	功期四化载酒攀天
绿草如茵羊盈瑞气	红桃似火猴沐春风
绿柳迎春风和日丽	红梅报喜鸟语花香
绿柳迎春山河焕彩	红梅报喜日月增辉
绿抹柳梢红燃花萼	春临世界喜降人间
绿水青山九州生色	金戈铁马四海扬威
马驰碧野风光溢彩	羊跃青山岁月流金
马列重温心明眼亮	人才辈出凤起蛟腾
马岁鸣金凯歌胜利	羊年擂鼓斗志昂扬
马蹄踏碎一穷二白	燕子衔来万紫千红
马跃人欢九州欢治	鱼肥秧壮四海春浓
马跃人欢九州笑语	鱼肥秧壮南国春浓
迈步迎春春风扑面	抬头见喜喜气盈门
满面春风喜迎宾至	四时生意全在人为
满室春风半庭月色	一窗竹影三径梅香
满天喜气九州若画	遍地春光四海皆春
曼舞轻歌东风惠我	张灯结彩春色宜人
面向世界虚怀请教	脚踏实地循序渐进
苗寨迎春香花吐蕊	乌江奏凯激浪和弦
妙道长存一尘不染	圆通自在万境皆空
妙手调和一江春水	能工巧染五色祥云
妙手同描三春美景	苦心共育四有新人
灭鼠消灾粮丰人寿	养牛致富国裕家康
民安国泰千门报喜	地瑞天祥万户迎春
民乐小康家家幸福	国欣大治岁岁平安
民欣岁岁安居乐业	国富年年锦上添花
民拥军意比泰山重	军爱民情似东海深
民族正气山川增色	功臣喜报门第生辉
明白人当家穷变富	改革者掌树亏转盈
明媚春光百花竞放	昌隆国运万马奔腾
明媚春光百花齐放	欢乐岁月五谷丰登
明媚妖娆春光织锦	英姿丰彩壮志凌云
明月在林万枝凝碧	春风鼓物一气含合
谋求发展义无反顾	创造辉煌大有作为
南水北调水润南北	西气东输气贯西东
年丰物阜家家康乐	日丽风和处处吉祥
念台胞山河抬望眼	思祖国日月寄归心
鸟语花香风和日丽	山青水秀国泰民安
鸟语花香江山如画	风和日暖大地皆春
鸟语花香满园春色	人欢马叫一路凯歌
牛奔福地普天献瑞	虎卧华堂满院生辉
农家户户小康富裕	华夏年年大业辉煌
农乃国基基劳国盛	民为邦本本固邦宁
努力实现四化理想	齐心建设两个文明
讴歌祖国千秋鼎盛	喜庆人民百福频臻
攀高峰不怕千般苦	闯新路何辞万里遥
攀高峰才可观壮景	掘深井方能得甘泉
霹雳一声春雷动地	昂扬十亿壮志凌云
普施善政黎民得福	广纳昌言盛世呈祥
七彩缤纷神州竞秀	百花绽放冀域增辉
齐心协力同描锦绣	携手并肩共创辉煌
旗耀五星天清地朗	政行两制民富国强
气化云烟顿添春意	雪中送炭足感盛情
千帆竟发前途无量	万马奔腾大业有为
千花岭上千枝竞秀	百姓门前百鸟争春
千里松涛无山不绿	万顷麦浪有地皆春
千里之行旅人素愿	一尘不染平步青云
千树岭上千枝竞发	百姓门前百鸟争鸣
千载难逢普天同庆	一元始复四海皆春
潜心改革鲲鹏展翅	锐意创新龙马腾空
强国富民深孚众望	褒廉惩腐大快人心
勤俭持家万财喜聚	科学种田五谷丰登
勤俭持家由贫到富	艰辛创业先苦后甜
勤俭持家有备无患	热诚爱国发奋图强
勤劳发家家庭幸福	统筹治国国运昌降
勤劳致富财源广进	家庭和睦满院春风
勤劳致富人和家旺	科技兴农林茂粮丰
勤劳致富山欢水笑	政策归心虎跃龙腾
庆佳节千门赞国策	迎新年万户颂党恩
庆盛世雄狮轻起舞	展宏图快马猛加鞭
全会精神映照千里	富民政策惠泽万方
人杰地灵百业兴旺	山青水秀五谷丰登
人杰地灵百业兴旺	山欢水笑五谷丰登
人杰地灵气壮四海	物华天宝春盈五湖
人杰地灵山河焕彩	政通民乐华夏开明
人民公仆潜心敬业	华夏赤子锐意兴邦
人民江山春风万里	社会主义幸福千秋
人民军队所向无敌	钢铁长城坚不可摧
人民为现代化拼搏	祖国朝新纪元腾飞
人人创建文明城市	户户争当模范家庭
人生无常转眼成空	离欲清净一心念佛
日和月和岁岁合意	天顺人顺事事顺风
日丽风和九州同庆	山明水秀四季呈祥
日丽风和神州雨霁	波平浪静海峡云开
日丽中天珠还合浦	龙腾盛世喜满神州
日暖风和畅行四化	花香鸟语喜洽三春
日暖福州春晖万里	兔回大地气象一新
日暖神州光辉万里	春回大地气象一新
日暖神州五光十色	春临大地万紫千红
日月增辉五星旗艳	乾坤交泰四海春新
如画江山九州春色	凌云志气一代春风
入世共赢金蛇喜舞	与时俱进紫骏欢腾
瑞霭祥云华天锦绣	清风朗月大地辉煌
瑞气盈门一元复始	春风拂面万象更新
瑞气盈庭一门兴旺	甘霖沃野五谷丰登
瑞日暖融山河似锦	东风浩荡大地皆春
瑞雪飞神州多壮丽	爆竹响山河尽朝晖
瑞雪飞神州岁岁美	乾坤转祖国日日新
瑞雪纷飞村村兆瑞	春风浩荡处处迎春
瑞雪纷飞银装四野	腊梅盛开香飘九天
瑞雪红梅千般姿态	青杨翠柳万种风流
瑞雪兆丰年千家乐	春风织胜景万象新
三春常驻风华永茂	百业俱兴国运恒昌
三代表播春风时雨	两文明绘舜日尧天
山青水秀九州如画	鸟语花香四季长春
山青水秀阳春有柳	人寿年丰幸福无边
山山水水诗画新岁	家家户户歌舞丰年
山舞银蛇春光烂漫	原驰骏马节日欢腾
社会安宁国臻大治	生活美满民乐小康
身处乐园和风正暖	宅临福地丽日方长
神州春晓普天同庆	前程似锦全家欣慰
神州壮丽流金溢彩	政策英明富国强民
生财莫忘崭新道德	致富须怀美好情操
生死海中念佛第一	人天路上作福为先
时代列车风驰电掣	建设蓝图月异日新
时逢盛世兴家创业	人遇丰年接福迎春
时雨春风五羊献穗	尧天舜日百凤朝阳
世纪百年始翻新历	人民十亿更上层楼
世纪更新春风得意	山河巨变华夏扬眉
世纪图新金蛇曼舞	神州大治玉宇澄清
世纪之交扬鞭策马	新年伊始飞雪迎春
市场活跃八方进宝	物资丰富四面来财
市场兴邦城乡共富	科技振国山海同春
势如破竹人欢马叫	安若泰山虎踞龙盘
室雅居安人人长寿	风调雨顺岁岁丰收
抒豪情恰似清江水	论日子正如映山红
树尽摇钱青山送宝	泉皆化酒绿水流香
双举文明云蒸霞蔚	十年业绩月异日新
水陆舟车四通八达	城乡客货纷至沓来
水色山光阳春万里	花香鸟语丽景九州
四方来财百业兴旺	五福临门万事通达
四海春风桃红柳绿	九州惠政物阜民殷
四海同心惠风和畅	万民共庆化日舒长
四化催春万家富裕	三中施政五谷丰登
四化宏图精描巧绣	九州春色浓抹淡妆
四化宏图千秋伟业	十亿愚公一代风流
四化建设蒸蒸日上	万里山河欣欣向荣
四时风景纷呈异彩	千古江山辈出英贤
四柱擎天九龙腾跃	八仙过海百姓安康
四柱擎天四时吉庆	五星耀地五谷丰登
松柏茂盛山河吐翠	芝兰芬芳玉宇飘香
送虎岁共庆山河壮	迎兔年齐歌业绩新
送马年春花融白雪	迎羊岁喜鹊闹红梅
岁首已瞻东风得意	金匙在握长策催人
岁序更新龙蛇竞舞	春风初度莺燕争鸣
岁月如诗春调韵律	江山若画党布丹青
岁增岁岁岁风光好	年复年年年气象新
桃花荡起千层银浪	玉树迎来万里金风
天复三阳群芳吐蕊	民欣四化各族同心
安居乐业家家春满园	丰衣足食户户喜盈门
白虎替青牛招财进宝	黄莺鸣翠柳辞旧迎新
白雪映红梅春回大地	凯歌偕丽日福满人间
百尺竿头重跨千里马	十亿人民更上一层楼
百花争艳风景无限好	万象更新江山分外娇
百花争艳祖国春光好	万马奔腾改革事业兴
百鸟鸣春春风盈大地	群龙献瑞瑞气满神州
百姓喜金瓯同歌宝鼎	九州辞玉兔共接神龙
百业俱兴降九州祥瑞	万船竞发听两岸猿声
半分屏山台闽本相接	一衣带水骨肉盼团圆
宝筴叶仙椿亿龄延祉	泰阶昭景曜九服均禧
爆竹更岁新桃换旧符	梅花迎春旧貌展新颜
爆竹两三声人间改岁	梅花四五点大地皆春
爆竹两三声人间是岁	梅花四五点天下皆春
爆竹三两声人间改岁	梅花四五点天下皆春
爆竹声声欢歌幸福岁	梅花点点喜庆致富者
爆竹声声龙吟随腊去	欢歌阵阵蛇舞伴春来
爆竹万千声人间换岁	梅花四五点天下皆春
爆竹响千家人间改岁	宏图描四化祖国皆春
爆竹一两声人间改岁	梅花四五点天下皆春
爆竹知人意声声悦耳	梅花晓天时朵朵欢心
北镇标云词林宗斗极	东瀛浴日学海跂壶天
碧海涌金波时光正好	云天放异彩景色更新
碧水绕华堂春光无限	黄莺鸣大地捷报频传
彩云绵画栋物华天宝	秀水绕新居人杰地灵
菜鸟大虾都上昆朋网	名星大腕共叙演艺经
草绿春新牧笛横牛背	花红昼永莺歌绕农家
阊阖象沼回萝图衍庆	蓬莱春茂鬯宝戺延祺
长晷丽前荣蓬瀛春驻	清芬飘合殿卿矞晴薰
朝爽启神霄蓂滋左砌	青阳升丽景芝秀东房
承前启后写中华新史	继往开来扬古国文明
城乡春回瑞气笼邻里	河山日拥祥云护德门
赤帜舞东风江山如画	赤骝奔大路祖国长春
雏鹰凌空当展兴华翅	老骥伏枥应怀报国心
川岳献甄符烟煴阐瑞	日月昭景贶糺缦呈华
创业思英才兰蕙并茂	拓荒看异彩桃李争春
创业维艰中原怀逐鹿	宗祧其永东海看腾龙
春到江淮万山添秀丽	国兴特色千禧展峥嵘
春风吹绿江山苏万物	旭日照明世界暖群生
春风春雨引万般春色	新岁新年开一代新篇
春风春雨迎万般春色	新人新事开一代新风
春风得意草木增秀色	时雨润心山河添笑颜
春风佛大地青山不老	瑞气满神州绿水长流
春风拂大地千花竞艳	政策暖人心百业俱兴
春风拂大地千枝竟秀	政策暖人心万众争先
春风浩荡江河披锦绣	华夏腾飞苍山映彩霞
春风浩荡山河添锦绣	华夏欢腾东风扫残云
春风浩荡山河添锦绣	华夏欢腾东风送祥云
春风化雨九州花满地	爆竹飘香万户喜盈门
春风化雨满园桃李香	丹心育苗遍地栋梁财
改革结硕果果香四海	开放绽鲜花花满九洲
改革起宏图神州巨变	丰年添笑语万事吉祥
甘做园丁为祖国添秀	愿为春雨育桃李成材
刚过龙年走上康庄道	新逢蛇岁迎来改革潮
港澳双归两制添异彩	炎黄同庆九州展俊容
工农携手共跨千里马	干群并肩同上一层楼
古国数千年伟乎鼎盛	长城一万里壮哉更新
鼓拼搏雄风宏开局面	立图强壮志振兴中华
官怀大志向造福社稷	民建小康村笑傲天堂
国富民乐山河呈瑞气	政通人和日月耀春晖
国富民强乐尧天舜日	闾安岁稔欣时雨春风
国色方兴普天开景运	春潮早涨大地发生机
国泰民安三元呈吉象	人和政善九域绕祥云
国泰民安一岁胜一岁	人寿年丰一年强一年
国泰民安众星朝北斗	风和日丽百鸟向南枝
国新政易新时时报捷	人老心难老事事争先
国兴旺年年风调雨顺	民富强岁岁人寿年丰
果硕花繁世界惊巨变	山欢水笑人民赞大成
海甸荟珍函沿波从朔	春阳迎绮陌倬汉成文
海晏河清民风光社稷	令行禁止法治定乾坤
汗水润喉欢唱丰收曲	政策指路敲开致富门
好政策调动千军万马	大市场幸福万户千家
昊岁启三元含和籥转	尧曦光四表承照华敷
贺大有万民盛赞四化	庆新春两岸殷期三通
红梅笑绽江南山似锦	白雪纷飞塞北岭如银
红梅争艳飞雪迎春到	万象更新新潮逐浪高
红日喷霞处处添画意	春风化雨点点动诗情
红日无私任万家分暖	阳春有意催百花争荣
红杏无私春分墙内外	青山有德泉灌地高坡
虎年生虎子虎头虎脑	龙人传龙裔龙子龙孙
虎跃龙腾创人间奇迹	莺歌燕舞描大地春光
虎跃龙腾建功九万里	莺歌燕舞造福两千年
虎跃龙腾全民歌盛会	羊欢马啸胜纪上新阶
虎跃龙腾有天皆丽日	花香鸟语无地不春风
互联网上拓宽致富路	科技园地盛开幸福花
花好常月圆人间同寿	根深叶不瘦天地长春
花好月常圆人民同寿	根深叶又茂天地长春
花团锦簇江山添异彩	虎啸龙吟华夏壮神威
花团锦簇江山添异彩	虎啸龙吟华夏震声威
化雨似甘霖恩及草木	春光催新政暖透人心
欢度新年家家彩灯艳	喜逢盛世户户春酒香
集八方信息生财有道	传四海科技致富无涯
继往开来弘扬三代表	与时俱进建设两文明
继往开来建设现代化	踌躇满志开发大西北
继往开来开创新局面	与时俱进俱兴大发展
继往开来山河腾锦绣	承前启后社稷竞辉煌
继先辈发扬革命传统	学雷锋誓做时代新人
佳节舞龙蛇千家致富	东风荣草木万户迎春
家有聚宝盆招财进宝	院栽摇钱树致福生财
甲子开元江山添秀色	东风化雨天地共长春
坚持原则按政策办事	深入实际同群众商量
减负又扶贫为民解困	下岗重就业替国分忧
建设四化赖一代俊杰	指点江山有无数忠良
健笔如椽歌尧天舜日	繁花似锦赖化雨春风
降雪无声乾坤一夜玉	安邦有继祖国万年春
金灿星辉东风传喜讯	湖尤山色大地播春晖
金猴棒奋千钧除腐败	盛世家兴万富民康宁
金镜开楹升恒光北极	珠勺映座长养顺动方
金镜霞明九苞开凤录	玉衡星正五色协麟文
金牛辞旧携凯歌而去	乳虎迎春带捷报新来
金阙云晴九华开彩扇	珠楼风细七宝拂炉烟
尽改一言堂鸟飞鱼跃	远谋千载业柳暗花明
经济繁荣四海歌善政	生活富裕亿民庆新春
经济腾飞结出丰硕果	文明建设催开鲜艳花
经营有道货自八方至	管理得方财从四面来
九州春色闹百花争艳	四化宏图展万马奔腾
九州春意闹百花争艳	四化宏图描万众显能
九州欢歌颂扬三代表	万民起舞共襄两文明
举步昂首攀登十八盘	跃马扬鞭飞越天柱峰
举国欢腾迎来五十庆	全民奋起跨进二千年
骏马金鞍跨上康庄路	肥猪元宝迎来大丰年
开放涌春潮九州明媚	改革掀热浪四海辉煌
开天辟地先辈耀华夏	继往开来后贤转乾坤
看旖旎春光浑耀天地	喜风流人物整顿乾坤
看旖旎春光重新日月	喜风流人物大展宏图
抗洪抢险虎年呈异彩	创业兴家兔岁立新功
科技入户春来千枝秀	文明临门冬去万木芳
科技兴农村村夸致富	文明重教户户喜事光
快马加鞭不坠腾飞志	吉羊昂首更添奋发心
快马舞东风春盈四海	梅花香大地喜满九州
葵花托金盘赤心向党	瑞云捧红日丹凤朝阳
愧白首一郎有辜明盛	愿青钱万选尽得贤良
腊尽春归山村添喜气	牛肥马壮门户浴春风
老老少少话古今巨变	家家户户乐万象更新
璃雪兆丰年家家欢喜	春光映大地处处生晖
立壮志为江山添锦绣	争朝夕与日月争光辉
丽日彤彤神州春似海	东风袅袅大地绿如茵
丽日耀三春飞花竞秀	东风催四化捷报增辉
励精图治雄心抒壮志	足智多谋胜纪建奇功
联对更新正气驱邪气	春光伊始今年胜去年
灵蛇立大功功垂千古	骏马迎新岁岁贺万福
两眼静观世界风云变	巧手绘就祖国平安图
留胜迹水秀山明草茂	谱新歌羊肥马壮春荣
六波罗蜜‘施’为首	四无量心‘舍’最高
龙去雄风在江山不老	蛇来灵气生岁月常新
龙舞秋云织中华锦绣	鸡啼春晓颂大业腾飞
龙子驾神舟探花及第	猴王庆盛世祭酒登科
律法严明九州欣大治	春风和煦万众话小康
马壮牛肥山村添喜气	地灵人杰门户沐春风
埋头钻研为未来攻关	刻苦学习替祖国增光
曼舞轻歌迎接新世纪	挥毫泼墨吟咏好山河
梅红雪白春景无限好	官清吏廉神州气象新
梅花点点笑饮丰收酒	爆竹声声高歌胜利年
梅花点点笑迎丰收岁	爆竹声声欢歌大治年
梅开五瓣浓抹三阳景	竹报三多淡妆四季春
梅雪争春山河添秀色	李桃竞艳岁月换新天
门饶清风勤为摇钱树	户纳艳阳俭是聚宝盆
描千里春色百花争艳	绘四化宏图万马奔腾
明镜高悬江山千古秀	执法如山花木四时春
鸣炮迎春春光盈大地	书联贺喜喜气满神州
年复年年年花香鸟语	岁增岁岁岁人寿年丰
年年过年年年不虚度	岁岁别岁岁岁不蹉跎
年年过年一年一个样	岁岁登高一岁一重天
鸟语花香九州春光好	人欢马叫四季画图新
盘瓠神将上天去报喜	天蓬元师下界来除灾
培养人才建百年大业	艰苦奋斗开一代新风
凭俭养廉开一代风范	纳谏从政秉千秋德操
七十老夫圆富足美梦	千年古国得安居太平
奇迹不奇实践能创造	高山不高只要肯攀登
奇迹不奇英雄能创造	远征非远良马自奋蹄
起凤腾龙千家争贡献	移山填海十亿尽风流
千家爆竹为河山喝彩	万户歌声唤海岳开心
千家富裕天开长春景	百业繁荣国成永乐洲
千秋大业从今天做起	万代福源靠妙手牵来
千枝竞秀有天皆丽日	万木争荣无地不春风
勤奋学习知识天天长	努力工作幸福年年增
勤俭持家雄心创伟业	劳动致富壮志营新居
勤劳动致富理直气壮	洒汗水生财家富国强
勤劳人家广栽摇钱树	科技钥匙常开聚宝门
勤勤恳恳培育新一代	兢兢业业争当好园丁
勤为致富之源年年发	俭是聚财之本月月红
青山不老人间多春色	绿水长流神州皆新图
庆佳节怀思台湾宝岛	迎新春祝福骨肉同胞
庆新春更念手足兄弟	辞旧岁倍思骨肉同胞
群英奋大业闻鸡起舞	春晖映五岭策马前行
群玉成山思文衍邰室	上奎柄耀绳武播豳风
人长久月长圆春长在	国永昌家永睦福永生
人欢马跃开创新局面	燕舞莺歌喜庆夏收年
人间传喜讯一元复始	大地发春华万木争荣
人心思治干群斗志旺	岁月逢春江山气象新
日历翻新力争红岁月	春联换旧催绣美山河
日丽风各水泛千层浪	天高气爽鸿传两岸情
日丽风和处处春盎盎	国强民富家家乐融融
日月光昭数风流人物	春秋笔在歌盛世英雄
日月知心人民大团结	春风得意江山起宏图
日月知心人民大团结	春光得意江山起宏图
瑞启青阳轩云承翠幄	祥开黄道羲日展金舆
瑞气满神州青山不老	春风拂大地绿水长流
瑞雪伴青松江山如画	和风拂翠柳祖国皆春
瑞雪冬梅红花映日展	春风杨柳佳卉向阳生
瑞雪纷飞大地萌春意	东风浩荡神州跃巨龙
瑞雪霁难山寒收玉宇	条风嘘内斗春满金瓯
瑞雪千家江山银万里	春风一树物野绿千层
瑞雪兆丰年春回大地	春光无限好瑞满人间
瑞雪兆丰年年年大吉	丑牛接寅虎虎虎生威
瑞雪兆丰年天开好景	金鸡啼远韵岁展宏猷
山欢水笑八方盈正气	物阜民康四海庆阳春
山明水秀处处皆春色	年丰岁余人人尽笑颜
山清水秀风光日日丽	人寿年丰喜事天天增
山下清泉饱含爱民意	树头翠果尽结拥军情
上下五千年英雄画卷	纵横八万里锦绣诗廊
韶序启青阳煦回岁籥	祥光腾紫气庆溢仙闾
申奥成功情系一一载	足球出线梦圆四四年
身老心不老老不服老	春新花更新新年更新
神州大地靠彩笔描绘	中华巨龙驾疾风起飞
圣德醍醐花深红药省	帝光糺缦日丽紫薇天
十六座丰碑与时俱进	五千年伟绩同日齐辉
十一亿神州民兴伟业	五千年历史大展宏图
十亿神州共驰千里马	四化建设更上一层楼
时令值新春风和日丽	人民逢盛世面笑心欢
书声朗朗校园萦瑞彩	笑脸盈盈文苑出新人
鼠去牛来一元欣复始	春明日丽万象喜更新
树立正气以准则为镜	端正党风从己身做起
树雄心攻克技术难关	立壮志攀登科学高峰
树雄心攻克科学堡垒	立壮志攀登世界高峰
双手茧花结出丰收果	一身汗水浇开幸福花
舜日尧天万民增福泽	和风甘雨四海沐春晖
四化报春来人人称颂	一年歌岁首处处欢腾
四季四方同奏四化曲	一年一步更上一层楼
四柱擎天看神州巨变	五星焕彩引玉龙腾飞
松竹梅神州共经寒岁	桃李杏两岸共乐新春
岁序更新马年留胜绩	春风初度羊志展鸿猷
岁月逢春山河添锦绣	人民思治龙虎振精神
探密驾神舟一帆风顺	兴邦驰骏骥万事亨通
桃李迎春北国江山丽	龟蛇献瑞南疆岁月新
特色中兴普天开景运	宏猷大展遍地发生机
同德同心开拓新局面	群策群力改变旧规模
万户千家齐奔现代化	五湖四海共知胜利年
万里春潮溶八方锦绣	九天晓日流五色云霞
万马扬蹄踏凯歌而去	群羊翘首唤春信即来
万木争荣人间添秀色	千山滴翠新岁壮精神
万象更新成城集众志	千帆竞发破浪乘东风
万紫千红呈九州春色	五讲四美照十亿心灵
万紫千红迎春须纵马	五风十雨顺水好扬帆
为人民服务一言九鼎	盼祖国统一九州一心
五彩纷呈艺苑春光好	百花齐放文坛景色新
五谷丰登银蛇载誉去	百花争艳金马踏春来
五讲四美是齐家根本	勤俭节约为富国源泉
五讲四美新风遍华夏	万紫千红美景展神州
物阜民丰祖国年年好	日新月异家乡处处新
喜九州春色百花娇艳	绘四化蓝图万马奔腾
喜炮闹元春千家接喜	春风荣蛇岁万户迎春
喜气满庭阶春来福地	凯歌传江海鱼跃龙门
喜气闹新年千家报喜	春风暖蛇岁万户迎春
喜气盈门政惠千家福	华光满目民欢万代春
喜庆丰收科研结硕果	欣谈致富教育供才源
喜鹊登梅百族迎佳节	金牛献瑞万里笑春风
喜鹊迎春红梅香瑞雪	吉羊贺岁金穗报丰年
喜上新楼看羊春前景	乐开彩电听马岁回音
喜四化征途莺歌燕舞	看九州大地马叫人欢
喜迎美好未来天地宽	乐创幸福生活日月新
下磨杵功夫终酬壮志	学取经本领大显神威
仙仗五云鸾鸣和盛世	德车七宿龙角运中天
先烈打江山伟业千载	吾辈搞四化福泽万年
献瑞灵蛇频传捷报去	识途骏马奋驾宝车来
香海飘香人民千载乐	港人治港祖国万年春
祥云捧日江山盈淑景	瑞气凝春社稷溢华光
小龙变巨龙腾飞巳载	老马是骏马跃进午年
效虎豪吟放怀歌富岁	闻鸡起舞挥笔颂春光
协气绕南荣苍车献瑞	条风来左序青锁含辉
心连两岸盼芳春永驻	情系三通期皓月长圆
新旧交替《声声慢》	岁月更迭《步步高》
新貌新风喜迎新世纪	好鞍好马驰骋好前程
兴邦开富路功归三代	布政绘鸿图福泽万民
星管叶珠勺祥开万象	云屏通碧汉瑞启三阳
雄师奋战创千秋业绩	俊彦挥毫谱一代风流
修渠攀岭碧流飞千里	引水上山银河落九天
旭日出东方光弥宇宙	百花开大地春满人间
旭日射铜龙上阳春晓	和风翔玉燕中禁花浓
雪铺富裕路银光闪闪	鹊叩幸福门喜报声声
言行并重兴中华伟业	法德兼施树社会新风
眼看河山已腾龙气象	胸怀世界要振马精神
艳阳高照江山添锦绣	壮志常存祖国更富强
阳光照河山河山添色	春雨洒大地大地生辉
养天地正气三宝为最	法古今完人佛陀至上
已有二月杏花八月桂	再添一时春雨三时秋
以慧眼看人无物不照	拿良心做事随处皆春
银箭应琅璈蓬壶昼永	铜铺开锦绣阆苑春浓
引甘泉浇灌满园新蕾	洒热血培育祖国未来
英雄儿女常存英雄志	锦绣河山再展锦绣图
迎新春处处春风拂面	祝喜酒家家喜气盈庭
有国才有家国家至上	兴家先兴国家国攸关
鱼跃鸢飞光景随时好	人欢马叫春潮逐浪高
与时俱进开世纪伟业	和党同行展小康宏图
雨顺风调千山生锦绣	人和政肃四海舞虹霓
雨顺风调中华铺锦绣	人勤春早大地沐祥光
玉管奏諴和气调九宇	璇枢徵广运衡正三阶
玉兔回宫喜迎新世纪	金龙下界更展大宏图
玉兔生辉照宽改革路	春风得意吹绽文明花
元象转星勺丹霄北供	重门映春树紫气东来
元勋漫舞轻歌辞旧岁	旦日欢天喜地迎新年
云霞蔚彩新年添福寿	山水韶光秀色满乾坤
泽雨润神州年丰国富	东风荣大地世盛民康
泽雨润神州山欢水笑	东风荣大地物阜民康
斩棘披荆党是先锋队	移山倒海团为后备军
战鼓催春声声震霄汉	东风化雨点点润人心
张灯结彩欢庆丰收岁	跑马耍羊喜迎艳阳春
张灯结彩欢庆丰收岁	跑马耍羊喜迎改革春
招财进宝勤劳是根本	发家致富科技做靠山
政策符心春风化春雨	汗珠落地黄土变黄金
政策架金桥土生百宝	科学播银种地出万金
竹林枝叶滴翠春增色	梅岭花蕊凝香雪添姿
紫气祥光碧海雄风劲	欢歌笑语春山瑞霭多
自力更生创千秋大业	发奋图强造万代幸福
自力更生创千秋大业	励精图治开万代宏基
祖国腾飞大鹏振羽翼	宏图再展乳虎显神通
遵路傍东垣擎霄春盎	近光瞻左掖瑞旭晨升
昨夕犬年欢歌迎大地	今朝猪岁新景满神州
八音响彻八方八方致富	七色光临七曜七曜增辉
百花争艳神州莺歌燕舞	大地生辉祖国桃红柳绿
百鸟鸣春堪喜人间换岁	群龙献瑞欣逢世纪更新
百业方兴到处五光十色	九州全盛应时万紫千红
百株松千株梅万竿修竹	五日风十日雨一抹春山
爆竹声声喜报前程锦绣	梅花朵朵欢呼万象更新
爆竹声中听到隆隆战鼓	梅花香里迎来滚滚春潮
爆竹一声送走因循守旧	礼花万点迎来改革开放
爆竹迎春春丽五湖四海	红梅报喜喜催万马千军
步新潮须骑骏马驰千里	兴伟业应唤春风惠万家
才过小龙年又催千里马	曾经大风浪更上一层楼
彩笔如花写就辉煌事业	春风似剪裁成锦绣江山
彩笔如花写就辉煌岁月	春风似剪裁成锦绣江山
沧海飞舟脚踏千层雪浪	昆仑立马眼收万里风云
闯学海沙里淘金求真理	攀书山若中寻乐作文章
承包好稻浪有风连麦浪	气象新庭园无处不花园
乘四化春风展千秋画卷	起九州生气迈万里征程
除夕猴在山重享齐天乐	迎春鸡报晓高唱东方红
春风吹春雨洒百花齐放	党纪严党风正万事皆通
春风催旧岁华夏百花艳	瑞雪兆丰年神州万象新
春风染沃野处处一片绿	喜报铺新途年年满堂红
春风送暖泽雨滋荣大地	佳节思亲黎民怀念小平
春光好春意浓春华秋实	民族兴民心顺民富国强
春光美山山水水欢歌奏	年景佳户户家家笑语稠
春花岁岁更新青山不老	时序年年除旧淑景长存
春回大地处处花明柳绿	福至人间家家语笑歌欢
春来兮大陆弟兄奔四化	时至矣台湾骨肉速三通
春霖降大地有情迎盛世	瑞雪舞苍穹着意报丰年
春起舞风拂大地捎新爱	燕飞翔语戏蓝天告旧情
春日融融万树繁花竞放	红旗猎猎千骑骏马争先
春柔马到他日必定成功	国盛龙腾今朝终能纵世
春阳送暖坚持中国特色	东风化雨发扬民主精神
春雨润苗万树千树竟秀	园丁勤育多出快出人才
辞旧岁欢欣鼓舞庆胜利	迎新春豪情满怀谱新篇
辞旧岁家家门前阳光道	迎新春户户窗外幸福花
辞旧岁劲松染霜松尤绿	迎新春寒梅映雪梅更红
辞旧岁十亿神州传捷报	迎新年万里江山扬凯歌
辞旧岁迎新春抬头见喜	抓良机走好运该我发财
辞旧岁祝丰年神州共庆	迎新春歌改革普天同乐
从朔贻规三院图书有典	指南锡极九霄云汉为章
促安定讲文明人心大快	迎新春展宏图前景辉煌
大厦落成到处欢天喜地	福人迁入满堂金碧辉煌
党民雄程玉局别开生面	国兴特色勋猷独领风骚
得申奥运进世足入世贸	将请财神接运气取公平
德政长存四海长歌德岁	丰碑共仰九州共庆丰年
东风浩荡人民安居乐业	大地澄清祖国稳定繁荣
东风劲吹山川香花朵朵	甘雨细润科研硕果累累
东西南北中处处传捷报	徵羽宫商角声声奏佳音
发星弹放神舟乐巡宇宙	迎澳门参世贸声震寰球
发扬民主国家繁荣昌盛	加强法制人民安定团结
发扬实事求是科学作风	巩固安定团结大好形势
发展多种经营财源茂盛	大高科学种田五谷丰登
法度除法轮法轮原无法	真经循真理真理终是真
翻一页日历存百年基业	绘千幅蓝图兴万代子孙
芳草先知喜报春归大地	梅花初吐欣观绿投满山
丰收年头莫忘克勤克俭	胜利时节切记戒骄戒躁
风调雨顺处处山欢水笑	政通人和年年国泰民安
逢佳节盼望河山归一统	迎新春倍思台眷共团圆
夫妻携手共织爱情经纬	男女并肩同酿事业琼浆
福星照吉宅新春家家乐	普天同欢度神州处处春
改革开红花呈中国特色	小康铺富路通人间天堂
改革鲜花开遍三山五岳	文明硕果结满万户干家
甘露无声绣出千红万紫	阳春有脚送来十雨五风
歌大治条条绿柳春光好	创小康副副楹联气象新
公道春风又绿神州大地	无私丽日重红宇宙长天
共产党政策温暖万人心	邓小平理论指引改革路
鼓雄风再展中华昌盛景	树壮志开创神州富贵天
固国体厚国基兴农为首	淳民风启民智重教优先
国兴旺家兴旺国家兴旺	老平安少平安老少平安
海无波涛海瑞之功不浅	林有梁栋林润之泽居多
含笑腊梅唤醒奇葩千树	溢香春笋挺起翠竹万竿
红梅开冻野千枝迎雪舞	绿柳发新柯万缕赖风裁
红日无私温暖五湖四海	春风有情染绿万水千山
红色电波常传九州喜讯	荧光屏幕再现四海奇文
红杏丛中朝见牛羊出圈	绿柳郊外夕闻鸟雀归林
宏图大展成就行行伟业	骏马奔腾飞越道道雄关
猴岁呈祥长空五光十色	鸡年纳福大地万紫千红
虎跃龙腾碧海黄山玉宇	莺歌燕舞春风旭日神州
虎跃龙腾碧水苍山玉宇	莺歌燕舞和风丽日神州
欢度佳节不忘骨肉同胞	喜迎新春怀念台湾人民
换旧符欢呼祖国瞳瞳日	开新宇喜看神州处处春
惠政暖民心乐小康岁月	春风融国土壮大好河山
货架上下朵朵红梅争艳	柜台内外张张笑脸迎春
货架上下汇集祖国春色	柜台内外倾注同志深情
极五岳奇峰抒迎奥壮志	倾三江急流写入世豪情
集资金储银行行行锦绣	开富路支农业业业辉煌
几代绿茵情往日情还在	两回奥运梦今朝梦已圆
家家户户处处干干净净	事事时时人人平平安安
健笔描春山水五光十色	新猷治国城乡万紫千红
健全法制立法执法守法	广举贤才思贤选贤用贤
讲道德树新风遵守法纪	学雷锋做好事为国利民
戒定慧三无漏学真善美	佛法僧稀世珍宝难遭遇
金猴举棒驱走千年旧俗	雄鸡报春迎来一代新风
锦绣河山党肇尧天新运	弦歌夏甸民欣舜日清平
京华迎奥运城乡添特色	宇宙翱神舟科技沐祥光
兢兢业业甘当祖国园丁	勤勤恳恳培育未来新人
九州大地处处莺歌燕舞	四化征途年年虎跃龙腾
九州大地到处莺歌燕舞	四海征途一路马叫人欢
九州大地皆春春风惠我	万里河山造景景色宜人
救死扶伤当好白衣战士	除疾解痛精求济世良方
居一得元秉神符而永极	交三成泰捧宝胜于重华
鞠躬尽瘁志在抚育新苗	埋头苦干誓做辛勤园丁
举杯放歌款款春风如洒	昂首阔步冉冉旭日多娇
举国上下促进安定团结	万众一心实现经济发展
举国上下齐颂龙马精神	男女老幼一健马到成功
举湖海为杯祝人民幸福	谱春光入曲唱江山多娇
军爱民民拥军情同手足	民养军军护民亲似鱼水
军民团结共筑万里长城	鱼水情深同绘四化宏图
骏马扬蹄奔驰峥嵘岁月	春风着意装点锦绣山河
开门见喜个个心花怒放	擂鼓迎春人人笑逐颜开
开门见喜个个心花怒放	辞岁迎新人人笑逐颜开
看祖国红旗招展景如画	望世界山雨欲来风满楼
科学坦途少有志方竟成	英杰豪气多无高不可攀
来于民养于民用之于民	安于军施于军赖之于军
老安少怀家庭和和美美	夫敬妇爱生活蜜蜜甜甜
老传统老作风发扬光大	新道德新风尚蔚然成风
林海安家窗含无边春色	青山着意胸有大块文章
麟定螽诜叶二南于彤管	星轩月殿配一德于丹宸
柳绿桃红都是革新气象	鸢飞鱼跃无非奋斗精神
龙蛇同体角有角无当辨	已巳异头尾长尾短当分
楼高厦大不分官宅民宅	气爽风清但见梅园杏园
陆台染红霞九州同妩媚	两岸瞻皓月千里共婵娟
律转璇枢三殿星云复旦	时调玉烛前门花柳同春
绿柳春风争颂汾水风采	秀塔伟楼笑看三晋新颜
绿柳舒眉争颂中华崛起	红桃开口笑看祖国添娇
绿水青山风景这边独好	红妆素裹江山如此多娇
绿蚁酌千家邀春风做客	红联贴万户趁节日抒怀
锣鼓喧天共奏迎春妙曲	风雷动地同抒致富豪情
锣鼓喧天共奏迎春妙曲	风雷动地同抒蹈海豪情
洛阳辽阳岳阳阳光普照	党风政风军风风情相通
门户放开引进新鲜空气	国家改革迎来灿烂春光
末法不念佛修行难有成	学佛无般若如同盲者行
沫春风展大业天高地广	迎朝日绣乾坤水碧山青
纳言荐才四化指日可待	反腐倡廉九州中兴有期
南疆雨北国风风调雨顺	东海龙西山凤凤舞龙飞
年景佳山山水水欢歌奏	春色美户户家家笑语稠
年年好景共建千秋伟业	处处春光大展四化宏图
浓墨映影描得山川秀色	巨毫生辉写就时代华章
企业自主干群意气奋发	质量优先生产捷报频传
千樽美酒共庆中华昌盛	万曲赞歌同讴祖国文明
千樽美酒共祝祖国昌盛	万支春歌齐唱人民富裕
巧借银屏向千家报喜讯	暂凭声像为四化唱赞歌
亲亲热热使你来得高兴	挑挑练练让你去得满意
勤学苦练攻克技术难关	精钻深研攀登科学高峰
庆丰收仓盈廪满喜洋洋	迎新岁家俭人足乐陶陶
庆虎岁把酒高吟虎跃曲	祝丰年扶犁又唱丰收谣
庆回归澳门齐唱迎春曲	行改革华夏共吟壮志诗
庆佳节户户家家喜事多	迎新春山山水水风光美
庆胜利举金杯春满万户	贺丰收展笑颜喜盈千家
庆新年千家万户贴红对	点春景五岳三山披绿装
去私心为民众甘当公仆	巨腐蚀正党风牢记准则
群策群力理顺经济关系	同心同德推动科技进步
人尽其材祖国一日千里	各得其所山河万象更新
人寿年丰生活越来越好	风和日雨春光如画如诗
人寿年丰生活越来越好	莺歌燕舞春光如画如诗
人心安定华夏千山竞秀	国运昌隆神州万木争荣
日挂中天普照九州国度	春回大地共绘四化宏图
日丽风和喜奏金蛇曼舞	民强国富远瞻骏马腾飞
日丽风和绣出山河似锦	年丰物阜迎来大地皆春
日映东嵎被光华于艺圃	源流北海挹沆漾之文澜
日月共长天同心相运转	江河合大海融会聚波平
日月循环堪喜人间换岁	风云际会欣逢世纪更新
日月重光三始同临首祚	天地交泰万象共庆新春
日照中天普照九州国度	春回大地共描四化宏图
入龙岁人人壮改革雄心	迎新年处处树文明新风
瑞日高悬塞北江南皆暖	东风浩荡天涯海角同春
瑞雪飞梅花笑景色绚丽	红旗扬凯歌奏战果辉煌
瑞雪飘飘喜伴神州美景	腊梅朵朵笑迎华夏春光
瑞雪无心抹去五颜六色	春风有意送来万紫千红
瑞雪莹莹百片千片万片	红梅灼灼一丛二丛三丛
三代表犹如珍贵三春雨	两文明酷似芬芳两朵花
山青水秀映改革千秋画	鸟语花香颂文明万代歌
善始善终行事莫留蛇尾	同心同德兴邦须借马威
深化改革一心共建大业	放开胆子举国同奔小康
神州华夏不可分离两地	炎黄子孙终将团聚一堂
生产致富送走一穷二白	勤俭节约迎来万紫千红
盛会展宏图弘扬三代表	中华兴大业建设两文明
识时机抛开近利谋远利	顾大局走出官场奔市场
十亿人民欢送神州旧岁	五湖景物喜迎华夏新天
世上无难事无心人不就	科学有真谛有志者竟成
书作良田百世耕之不尽	勤为至宝一生用则有余
淑气凝和天上香浮簇仗	条风扇瑞宫中日永垂裳
树高千丈有赖阳光雨露	铁杵成针全凭日久功深
数树红梅点燃千家喜爆	一轮朝日迎来万户春光
水碧映山青青山映碧水	花红扶叶绿绿叶扶红花
四化宏图辉映五湖四海	政策落实调动万马千军
四柱擎天天宝物华人杰	五星耀地地灵国泰民安
松香竹香梅香香风阵阵	天美地美人美美意重重
送虎岁盈盈硕果山村景	迎兔年丽丽宏图祖国春
送金虎硕果丰收千里艳	迎玉兔宏图再展万年青
颂党恩瑞日祥云遍宇宙	赞改革春风和气满乾坤
岁时新春意浓神州焕彩	宏图美阳光艳大地生辉
岁岁辞旧岁往岁逊今岁	春春迎新春来春胜今春
天马行空日丽风和雨顺	灵蛇在世政通国泰民安
听遍地豪歌征人添虎劲	看漫天彩霞战马长精神
同心同德共砌神州大厦	一国两制成全祖国版图
兔岁初临健步已驰千里	虎年虽去雄风犹镇八方
外行变内行行行出状元	后浪追前浪浪浪有奇峰
万点红梅迎来三春锦绣	十亿赤子建设两个文明
万化转璇枢本天而本地	一元开瑞筴资始以资生
万里江山重见尧天舜日	九州草木共沾时雨春风
万里江山重见尧天舜月	九州草木共裕时雨春风
万马奔腾为江山添锦绣	宏图再展与日月竞光辉
万众一心创造锦绣乐园	五讲四美建设精神文明
望台湾春风牵动满腹意	盼亲友海水紧连两岸心
为官当权愿你一尘不染	离职卸任看我两袖清风
为国争光可上九天揽月	给民造福敢入四海擒龙
为子孙创业宏图惊日月	替祖国争光奇志壮河山
纬地经天交织人间锦绣	马龙车水频添大块文章
文明经商货流五湖四海	礼貌待人心向万户千家
舞长龙为大地回春祝福	耍猛狮给神州崛起壮威
物阜民康改变一穷二白	风和日丽欣看万紫千红
惜时胜惜金人人求进步	树德如树木事事作先锋
喜丰年粮似金山棉似海	看成果山通公路水通桥
喜洋洋绿水青山春永驻	美泰泰丰衣足食福无边
喜迎春春风得意春常在	抬望柳柳叶多情柳半垂
喜迎春念台胞天涯咫尺	盼回归寄祖国无限深情
细雨无声滋润满园锦绣	春风有意妆成一树玲珑
想当年逢人只说三分话	喜今日向党全抛一片心
新历迎年人贺重光舜日	椒盘献岁家欣再乐尧天
星转璇勺光映卿云五色	春回玉管祥开彩胜千枝
杏雨飞红喜织千家春色	和风着绿巧绣万里新图
胸怀祖国利益坚持真理	甘当人民公仆不搞特权
雄鸡一唱扫尽残星晓月	万众齐欢迎来化雨春风
修九亿方库客截流发电	筑八十里堤坝排涝防洪
旭日腾彩霞春色无限好	红梅傲霜雪江山分外娇
旭日祥云灿九州花似锦	春风化雨新四海歌如潮
学海千重看我飞舟横渡	书山万仞祝君捷足先登
血碧心丹描绘三湘图案	花香鸟语装点四面关山
滟滟江流映出满天霞蔚	声声爆竹迎来大地阳春
羊笔如花写就辉煌岁月	春风似剪裁成锦绣江山
羊笔生花喜写辉煌岁月	春风似剪精裁锦绣山河
一楼梅香烘出无边春色	三声鸟语闹来万里祥光
一路铃声捎去丰收喜讯	万家笔语带来富裕佳音
医有秘方可使万民益寿	药无凡草能救百病回春
以天下为己任丹心似火	把旅客当亲人笑脸如春
忆往昔沧桑含雪千花坠	看今朝寰宇绽春百鸟飞
莺歌燕舞笑迎神州巨变	虎跃龙腾欢建华夏文明
迎虎年敢逐改革拦路虎	送牛岁勇当奉献老黄牛
迎新春处处呈文明气象	入虎岁人人当改革先锋
迎新春千门开抬头见喜	奔四化万人起举步生风
迎新年满园春色满园锦	辞旧岁遍地鲜花遍地歌
迎新年三江春水三江洒	干四化一寸光阴一寸金
有脚阳春先到故园桃李	无心明月偏临近水楼台
与众同甘苦不搞特殊化	为民谋幸福愿当孺子牛
雨霁雾散百花扬眉吐气	浪静风平万船击水争流
雨顺风调喜见春华秋实	云开雾散得亲舜日尧天
玉兔回蟾宫长空悬朗月	金龙上华表大地庆新春
掌万家灯火为江山生色	看一派光明让日月增辉
正党风壮志为公行大道	昌国运英雄创业展宏图
知身不是我烦恼更何侵	常乐破四相当下即涅槃
植树造林四水三湖耸翠	栽花种草千家万户飘香
指富路奔小康名垂后世	乘东风跨赤免马到成功
志在八方何惧山高路远	龙游四海哪怕浪急风狂
中华入世贸全球同发展	港澳回母怀举国共欢呼
中华三度腾飞全民共庆	宇内千般改革万物皆春
众志成城四化宏图在望	繁花似锦千秋幸福绵长
重调整众手栽培摇钱树	求安定群力塑造聚宝盆
周昭王甲寅年佛生西域	汉明帝乙卯岁法流东土
抓消防除灾害万众康乐	兴保险保安全九州呈祥
紫燕高飞剪开千重云雾	布谷欢歌唤起万家春耕
紫御迎春瑞拂千条御柳	丹楼映日祥开万书宫花
自主经营厂家如虎添翼	大胆改革质量似锦添花
祖国山河处处尽展锦绣	中华儿女人人皆称舜尧
尊师重教四海群芳竞秀	革故鼎新九州万木争荣
百花争艳欣望江山千里秀	万民欢庆齐颂祖国万年春
百业方兴山海多姿皆入画	三春伊始神州无处不飞花
百业振兴锦簇花团十六大	三阳启泰风调雨顺万千春
百折不回矢志练成真本领	一心向党相期莫负好年华
宝瑟和瑶琴百子池边春满	金柯连玉叶万年枝上云多
爆竹飞花四海升平歌富有	金风献瑞九州安定纳祯祥
爆竹飞花四海升平庆富庶	金龙献瑞九州欢乐唱丰年
爆竹千声长城内外丰收岁	红梅万枝大江南北艳阳天
爆竹一声喜送巳蛇留庶绩	华灯万盏欣迎午马展嘉猷
爆竹迎春春光明媚人心畅	金龙还世世纪崭新国力雄
北斗回寅万户金鸡争唱晓	东风送暖九霄玉兔喜迎春
奔四化跨进世界先进行列	追科学攀登现代技术高峰
碧野青山一方胜地来天外	红楼绿树十里新城入眼帘
彩凤高翔恋我中华春不老	金鸡喜唱歌斯盛世乐无穷
藏龙卧虎华夏大地春常地	人杰地灵文明古国尽朝晖
策马奋进十六大春潮迭起	牧羊登高小康路神州放歌
策马争春马跃马年加马力	驾龙追日龙腾龙国振龙威
茶溢清香戴露朝阳浮绿叶	场开沃野连畦接壤育新苗
朝阳似火党旗指引青春路	捷报如潮新纪迎来锦绣天
城镇腾辉古国风光开眼界	乡村溢彩小康岁月乐心头
持名功夫贵在念念无间断	德行高尚令人频频闻妙香
赤帜高扬追星惟向先锋队	青春永驻接力堪钦后备军
帱载浃祥和纠缦交呈旭采	智仁谐乐寿纯常懋迓春祺
除旧布新远近声声传捷报	扬长避短城乡处处沐春晖
春到人间花红柳绿千山秀	节逢岁首日暖风和万水欢
春风春雨春色无边春意暖	福地福门福光有情福气浓
春风春雨育春花春满大地	喜山喜水织喜景喜盈神州
春风得意辉煌景灿辉煌世	政策舒心富贵花开富贵家
春风得意顺势而来腾飞马	节日涣然急流勇退入世蛇
春风得意扬鞭奋蹄跨骏马	红云当头建功立业送小龙
春风得意亿民奋斗创大业	惠政随心百族团结建小康
春风如意农民巧手绘画卷	细雨随心田园诗人写绿茵
春回大地梅花点点风光美	福至人间笑语声声梦里甜
春回大地山清水秀风光好	日暖神州人寿年丰喜事多
春联表心境贴上便添喜庆	大赛传友谊参与就有知音
春满神州千禧三春花吐锦	龙腾凌水东风万里歌如潮
春满神州山欢水笑龙吟曲	民安乐土燕舞莺歌蝶恋花
春满神州树上摇钱如蝶舞	花开艺苑盆中聚宝似莺飞
春暖人心世界三千同雀跃	风搏羊角云程九万共鹏飞
春夏秋冬四季服装皆溢彩	东南西北八方顾客尽开颜
春扬大地千山叠翠凭虎跃	日仰中天四海扬波任龙腾
春意昂然东风细雨芳园翠	翠岚烂漫玉树琼花满目春
春意盎然祖国山河千载秀	东风浩荡神州大地万年新
春雨宜人家家畅饮贺新岁	和风送暖处处欢歌奔小康
翠柏苍松装点神州千岭绿	朝霞夕阳染就江山万里红
村村寨寨琼楼玉宇风光好	家家户户红花绿叶气色新
打黑扫非德治和法治并举	倡廉反腐党威与国威齐扬
大地春回爆竹红灯一同醉	渔村人早春风流水齐送行
大地春回千里金涛香万户	小龙蛰起九州紫气贯长虹
展宏图九州英才扬鞭跃马	创伟业四海豪杰破浪飞舟
展智施能雄心共创千秋业	扬鞭跃马矢志同奔万里程
政善官清九州大厦千秋固	国强民富四化繁花万里香
政善人和入世欣乘千里马	日新月异兴邦更上一层楼
知春爱春歌唱春天新故事	入世明世构思世界大文章
鳷观翔云九译同文朝玉陛	凤楼焕彩八方从律度瑶阊
志安国泰齐山岳彰明秉宪	胸蕴民情系暑寒秀蔚成春
志气凌云争分夺秒搞开发	春光似锦良辰美景祝千秋
志在青山汗水浇绿山千万	献身峻岭热血映红岭万千
珠缀绕龙屏宝矩光连宝箓	璇题悬凤扆彤云瑞应彤墀
竹报三多绿竹千竿同茂盛	梅开五福红梅万朵共芳菲
壮丽城乡水流新韵山流翠	腾飞岁月民向小康国向荣
紫极正中央万国共球并集	青阳迎左各千门雨露皆新
紫燕迎春一路东风歌大治	金鸡唱晓九州时雨润小康
自改革来千古羊肠成大道	由开放始全新人面满春风
总结经验事事应当看实践	吸取教训时时需要戒空谈
走社会主义道路爱国爱教	扬般若波罗密多弘法利生
做个好人心正身安魂梦稳	行些善事天知地鉴鬼神钦
大地春回万里河山呈画卷	长天日丽九州儿女绘蓝图
大地春回祖国山川放异彩	艳阳高照中华儿女绘新图
大地回春不尽江山抒特色	香花扑面无边风月竞贤才
大地回春锦绣河山添异彩	征途跃马英雄儿女着先鞭
大地回春千山披翠千山美	春风送暖万水扬波万水欢
大地同春情寄东风联两岸	中华一统国如磐石固千秋
大地迎春柳伴梅香招蝶舞	高天降雨犂掀黄土应蛇行
大地迎春柳伴梅香招蜂蝶	文坛焕彩笔掀墨浪舞龙蛇
大好河山桃红柳绿春风渡	小康社会国泰民安喜气生
大江东去污浊荡尽乾坤赤	小院春回福乐频传日子甜
大开大放虎跃龙腾奔四化	双节双增莺歌燕舞入三春
大陆台湾金桥飞架诚可望	同胞兄弟骨肉团圆定有期
大圣辞年万里河山留瑞霭	雄鸡报晓千家楼阁映朝晖
大业方兴五星旗展金鸡唱	小康在望四化图开彩凤飞
大业有成瑞雪皑皑辞岁去	节气更替红梅点点唤春来
大业有望东风习习送冬去	气象更新红旗猎猎迎春来
丹风来仪人寿年丰新岁月	春风送暖梅开雪映好山河
丹蜂朝阳红梅映雪千山秀	神州簇锦凌水腾龙万里春
党恩浩荡万里江山披锦绣	国运昌隆千秋岁月铸辉煌
稻花钢花科技花万花竞艳	农业牧业工商业百业振兴
德治厂兴众腑长铭三代表	业精勋著群英力建两文明
点点梅花笑迎雄鸡朝天唳	声声爆竹欢送大圣载誉归
电视机前辞旧岁偕欢半夜	互联网上贺新春并喜五洲
叠翠飞花不老青山添生气	滚珠溅玉长流绿水唱丰收
东方风来山寨频添科技户	南天雨润农家新建读书楼
东方丽日耀明时红舒九野	法治熏风苏冻土碧透三江
东风浩荡祖国处处展新貌	旭日东升神州在在尽朝晖
东风劲吹老树新枝齐竟秀	阳光普照嫣红姹紫尽争春
东风送暖万卉争艳风光美	政策落实百废具兴人心欢
冬去春来肥田沃土景观美	莺歌燕舞巷尾街头景色新
冬去春来锦绣山河放异彩	涛走云飞峥嵘岁月纳同心
冬去春来千条杨柳迎风绿	民安国泰万里山河映日新
多难兴邦唯有民生难解决	同仇抗日纵亡种族莫投降
发展生产城乡面貌在改变	搞好经济市场渠道已疏通
法似春风廿载频频襄社稷	心如晓日四时脉脉照家邦
法雨普施涤除尘垢三千界	德风广布吹绽馨香十亿花
反腐肃贿惩贪民心皆喜悦	倡廉纠风整纪国运更昌隆
饭热菜香贵客盈门庭似市	言甜情厚高朋满座店如春
放眼神州心旷神怡歌大有	举目大地山欢水笑倾长春
非锡非铜终日经营修马铁	得钱得米新年欢喜赚龙洋
奋斗毕生励志勤磨三尺剑	纵观今古豪情雄唱大江东
风和日丽山美水美风光美	年丰物阜人新事新时代新
风和日暖男男女女迎春节	国泰民安户户家家颂太平
风景秀丽五洲好友慕名至	江山多娇四海佳宾接踵来
凤起蛟腾四海英才齐报国	龟动蛇出九州风物笑迎春
凤舞龙飞锦绣河山添锦绣	蛇祥龟瑞富强中国更富强
凤舞龙腾腾龙兴国创新业	人欢马跃跃马扬鞭赴前程
凤竹清风霞染新色情烈烈	龙梅皎月露沾古画意深深
夫唱妇随并肩共赴小康路	孙贤子孝携手同迎大有年
福光高照花红柳绿春不老	乐事亨通物阜家丰岁常新
福降神州万里河山生秀色	春回寺地八方黎庶沐朝晖
赋改革新诗字字珠圆玉润	奔富强正道人人虎步龙骧
改革开放神州巨变真无比	奋发图强骏马奔腾大有为
改天换地狮啸八荒光八极	揽月摘星龙吟九派熠九州
肝胆相照广开言路商国是	荣辱与共各献神通建中华
皋应辟春阳瑞气常浮五雉	羲和回日驭卿云时捧双龙
高速公路高新技术高科技	新构华章新颖主题新思维
歌传统美德花满千禧庭院	诵创业精神果累新纪家园
革故鼎新十亿神州歌盛世	倡廉反腐千秋禹甸庆兴邦
革故鼎新物阜粮丰十里秀	安居乐业地灵人杰万家欢
庚岭东西梅放千枝报春早	大江南北雪飞六曲兆年丰
恭贺新春发财致富开新路	欢辞旧岁反腐倡廉革旧章
共展宏图开放招来珠履客	同兴伟业革新造就锦囊才
鼓角争鸣跨纪龙骧腾热浪	旌旗漫卷开元虎步舞长风
鼓乐齐鸣四海欢腾迎大节	华灯怒放三江锦绣喜康民
光景无边遍地笙簧歌化日	前程似锦满园桃李笑春风
国富民殷羊毫挥颂千秋业	年丰人寿燕剪裁成万点春
国泰民安江山万里清平乐	龙腾虎跃禹甸千秋吉庆年
国兴特色绿水青山皆献瑞	民乐小康碧桃红杏共争妍
国运亨通化雨春风苏大地	人心快慰丰衣足食庆华丰
海阔天空波光云影皆诗画	地灵人杰文采风流继宋唐
海峡同心一统江山人共盼	春风两岸团圆骨肉众相期
海宇安恬圆峤方壶开福地	天阊詄荡右平左砌上熙台
豪情不减一腔热血灌桃李	白霜日增满腹文章颂春秋
浩气常存频加马力奔新路	雄风不减再握羊毫绘壮图
河山毓秀古国春色耀青史	岁月更新中华雄姿震寰球
红梅点点盘瓠傲霜随岁去	丽日融融天蓬报喜伴春来
红梅献岁鹊立枝头歌盛世	绿柳迎春莺穿陌上唱中兴
红日初生万户想云临复道	青阳乍转九天佳气敞重楼
红日吐辉伟大祖国更兴旺	江山多娇锦绣前程倍光明
鸿雁来宾破雾穿云传捷报	绿衣使者翻山越岭沐春风
猴岁吉祥竹梅报喜报祥至	鸡年幸福莺燕衔春衔福来
厚德载物普天华夏迎春庆	立法匡国沃野神州与日兴
厚德著璇宫禁掖常尊尧舜	修龄储北斗春秋永亘贞元
湖上春未春杨柳桥头可问	人间乐不乐管弦元夜如何
湖水碧绿尾尾鱼群待撒网	春光明媚匹匹骏马好腾蹄
虎步龙骧共创九州新世纪	莺歌燕舞同观四海好风光
虎将三千曾驭红鬃还伏虎	龙人十亿才跨赤兔又乘龙
虎慢归山因贪人间好春色	兔急下界为览世上新画图
虎岁三十爆竹声声辞旧岁	兔年初一红联对对迎新年
虎跃龙腾碧海黄山妆玉宇	莺歌燕舞春风旭日蔚神州
虎跃龙腾华夏人民多俊杰	莺歌燕舞阳春山水尽朝晖
虎跃龙腾三代英才开世盛	山青水秀九州春色泛桃红
虎跃龙腾兴邦踏上康庄道	山欢水笑造福迎来锦绣春
虎镇千山虎威长励英雄志	兔营三窟兔智频催改革风
花栋连云燕子重来应有异	笙歌遍地春光常驻不须归
花好月圆酉阳倍艳新春暖	民安国泰申雪犹香旧岁丰
花红柳绿河山壮丽门庭秀	民富国强龙马奔腾世纪新
花红叶翠秀丽黄莺鸣暖树	人勤春早辛劳紫燕恋春泥
花著上林花开富贵芳千树	国施良策国肇昌隆裕万家
华夏龙腾长城内外皆春色	神州虎跃大江南北尽朝晖
华夏腾飞时势造就新业绩	巨龙昂首英雄独领好风骚
化日舒长五纬祥光连斗极	惠风和畅六符瑞采焕台阶
化雨宜人家家畅饮贺新岁	春风送暖处处欢歌奔小康
画海诗天神州美景能人绘	云龙山虎禹甸宏图巧手描
欢庆丰年喜炮喧天天赐福	喜迎春节欢歌动地地生财
黄道天开东壁琛图辉玉宇	紫宸日丽西山爽气映瑶阶
惠风和畅巍巍泰山拥旭日	春雨润泽滔滔东海泛春潮
鸡唱寰中改革大潮迎岁改	春临大地繁荣事业似花繁
鸡唱门庭四海升平歌舜日	犬蹲院里九州盛世乐尧天
鸡唱三通万家春正乾坤气	凤鸣两岸一树梅开天地心
鸡唱月归一线长天皆瑞霭	犬歌日出九州大地尽朝晖
激浊扬清宇宙新陈常代谢	兴邦治国人间美丑总分明
济困扶危道德中间查内力	拒邪防腐法规深处找基因
继往开来世纪春光无限好	承前启后神州骏马有奔头
继往开来蹄声似鼓惊天地	兴邦强国志气如虹展画图
继往开来万里山河迎丽日	承前启后千秋岁月笑春风
艰苦奋斗传万家家家致富	励精图治兴百业业业更新
江南洒绿茵锦绣一方天地	塞北飞白雪银装半壁河山
江山似画千秋翰墨千秋景	岁月如诗一代风骚一代歌
江山壮丽古国风华光禹甸	祖国日盛人民熙攘乐永衢
讲话指南壮志勇腾千里马	群星拱北新年更上一层楼
蛟龙跃起神州振奋三捷报	骏马腾飞祖国扬威四海春
捷报频传圣猴舞棒辞岁去	宏图再展金允高唱迎春来
捷报频传万里雄风惊宇宙	宏图再展九天春色壮河山
借五彩声屏欣看大千世界	喜四时春色铺满万里河山
金棒一挥日丽风和天可物	雄鸡三唱山明水秀地宜人
金戈铁马三军猛士戍边邑	伟业殊勋一代精英振国威
金鸡报晓改革似春风化雨	彩凤朝阳腾飞如旭日升华
金鸡报晓时转三阳迎淑气	红梅竞放花开五福庆丰年
金龙穿云端裁剪千千锦缎	玉蛇舞大地巧绣万万彩旗
金龙舞神州歌盛世腾飞曲	玉兔奔月府献千禧伟业图
进军马随进军号跃进千里	入世龙乘入世风腾入九天
经济繁荣处处常奔千里马	人民幸福家家更上一层楼
经声佛号唤回苦海迷津人	暮鼓晨钟惊醒世间名利客
荆艳莲香龙国迎春花织锦	日新月异宏图焕彩景迷人
景丽瑶墀鸾鹤翔空腾庆霭	春回琼岛鱼龙献瑞展新图
静泰怡神瑞霭光辉临黼扆	冲融契道祥风蔼吉畅文轩
九囿风和一寸邮花开万里	三胞韵美八行笺月照双心
九域风和沃土肥泥生万物	三春雨润新天丽日绽百花
九域歌喧国泰民安风日好	三春花发嫣红姹紫画图新
九域迎春九域辉煌惊世界	三军报捷三军威武卫中华
旧岁蛰蛇蛇舞青山山愈秀	新春跃马马奔大路路更宽
涓流细细终归大海成波浪	碧草纤纤得遇春风便纵横
军民一家铁壁长城千里固	党政协力锦绣江山万年春
骏马奔驰满载乌金辞岁去	吉羊起舞豪吟白雪报春来
骏马奔腾满载而归辞胜岁	羚羊奋跃高歌猛进贺祥春
骏马辞年不懈奔腾千里志	吉羊献岁同迎欢乐万家春
骏马荣归一路梅花频送笑	吉羊欢驾九州绿草快铺春
科技振兴兴国兴业山河壮	勤劳致富富家富民岁月新
科学种田金银财宝春潮涌	勤劳创业福寿康宁气象新
克己奉公两袖清风做公仆	护国安民一身正气靠品德
肯流汗水浇来田野千年绿	能下苦功绘就宏图四季春
跨纪龙吟国运与时彰盛典	流年鸡唱家声翘楚领长风
跨世纪公安事业跃马扬鞭	开新元人民警察再续辉煌
快马加鞭协力同心跟党走	葵花吐蕊栉风沐雨向阳开
快讯佳音电视广播皆入耳	新闻趣事报刊杂志最关心
老骥伏枥退休续谱夕阳曲	苍松傲雪余生再唱春牛歌
老马识途奋驾长车奔富路	银蛇献岁昭苏万物舞东风
老马识途破雾导航奔胜境	吉羊接力承先启后展宏图
老一辈开天辟地恩泽四方	新一代承先启后功垂千秋
老有所为莫为利已损人事	书宜常读多读修身治国篇
乐辞鼠岁处处丰收人人乐	歌颂牛年家家富裕户户歌
雷震南天滚滚春潮生九域	鸡鸣大地彤彤旭日耀寰球
理论导航改天换地宏图展	龙人奋志革固鼎新特色兴
理水治山华夏千秋开异彩	改天换地神州万里着新装
丽日蓝天万树繁花争早放	阳关大道千骑骏马着先鞭
丽日悬天腊尽春回华厦美	神州翘首山呼水唤游子归
丽正凝祥境引琅环开积秀	熙韶荟景曜连奎璧启当阳
镰运锤挥万古江山开盛世	龙骧虎奋九州儿女创殊荣
两个文明同建设无分甲乙	四项原则共坚持永传子孙
两馍一菜就三餐餐餐随便	一夜三更分两岁岁岁平安
两日子时聚一年年年同庆	一夜三更分两岁岁岁平安
两制生辉赤子归来慈母愿	九州壮色雄狮已醒普天娇
灵蛇辞岁申奥入世双遂愿	骏马迎春富国强民共筹谋
灵蛇开泰好事连连圆夙梦	骏马续祥良机比比展宏猷
灵蛇谢岁锦绣河山添锦绣	宝马迎春辉煌祖国更辉煌
柳岸建楼满屋豪华满屋笑	春江撒网一仓欣喜一仓歌
柳暗花明同熙禹甸长春地	风和日丽共戴神州极乐天
柳拂春风马蹄得意奔新路	云蒸丽日喜鹊登枝报福音
柳绿花红共道人间春色美	龙腾虎跃喜看华夏画图新
柳絮凝烟风景千般留客赏	春潮带雨画图百幅任人描
柳展新姿大地又添千顷绿	花开笑口人间绽开万川红
六管宣和乐奏钧天回暖律	三阶供极图呈益地迓新祺
六合回春郊外梅花堤外树	九州聚宝山中果木水中鱼
龙飞凤舞人间喜庆丰收年	燕语莺歌大地迎来胜利春
龙归大海滚滚春潮逐浪起	蛇舞青云浓浓喜气盈门来
龙虎精神龙子龙孙功不灭	江山锦绣江南江北水长流
龙闹北溟千里冰凌千里雪	春回南岭万枝火桔万枝梅
龙年龙裔看龙舞龙飞天上	春节春风送春光春满人间
龙舞雪花四野寒风随雪尽	蛇衔春色九天暖意逐春回
龙骧新纪党政军民同春进	蛇步锦程工农商学共腾飞
龙种自与常人殊况逢龙岁	鹏鸟岂堪同日语绝胜鹏搏
路路为盘着意布来宏业势	桥桥结网殷勤筑就丰功碑
绿柳枝头紫燕呢喃歌改革	红桃树下黄莺宛转话腾飞
绿影鸿飞邮路春风播四海	清音雁递电波喜讯报千家
马去蹄香北国又添千里马	羊来春暖南疆再现五仙羊
马去羊来华夏腾飞添马力	龙吟虎啸天公抖擞降龙才
马首是瞻美酒千盅迎曙色	羊毫初试豪情万斛写春光
梅柳迎春万里东风绽桃李	椿萱含笑一门和气乐桑榆
门对青山羊兔群群嬉碧毯	窗含绿水鸭鹅队队戏清波
门户敝开迎八方春风入院	房舍洁净接九州宾客归家
妙笔千枝画不完人间春色	美喉万啭唱不尽改革凯歌
末法修行净土为归方向正	一切法门般若为导慧灯明
默默无闻育出桃李芳天下	济济有志造就栋梁兴中华
南国春浓日暖风和花弄影	北方物阜年丰岁乐酒飘香
年丰物阜迎来大地尽春光	朝霞夕照染成夏甸万般红
年年进宝年年添福年年乐	岁岁来财岁岁增寿岁岁安
年年腾跃一江春水重重浪	岁岁攀登百尺竿头节节高
牛耕广野丑年犁出文明路	虎跃深山寅岁图开舜尧天
农业丰收举国欢腾歌稔岁	心花怒放全民喜舞庆新春
浓墨重彩写不完人间春秋	千歌万曲唱不尽党的恩情
浓语一席畅谈去岁欢心事	美酒三杯喜庆今年如意春
盘瓠将军奉命辞岁报功去	天蓬元帅领旨迎春送宝来
丕振家声百尺竿头争进步	远谋国是九州天下又回春
披金挂翠滩涂开发穷涂变	送宝献珍铁路兴修富路通
普天同庆一片红霞迎旭日	大地腾欢万条绿柳舞东风
祈福应知福福祉常缘善念	盼春该识春春光永驻仁心
旗飞何方旗飞骏马嘶风处	春出哪里春出京城决策中
气贯长虹四化征途催战马	志凌霄汉十亿英雄唱新歌
气正风清五岳长安祥鹊舞	帆高水阔三江久治瑞云飞
千帆竞发几经风雨几经浪	万马奔腾一路凯歌一路春
千古江山增秀色春光无限	万家人面映桃花淑气有缘
前路辉煌笑看骏马追风去	雄雷霹雳喜见商羊带雨来
勤勤恳恳不愁没有摇钱树	俭俭省省哪怕难得聚宝盆
青松翠竹万里河山春永驻	绿柳鲜花千层波浪事方兴
青松翠竹万里山河春常在	柳绿花红神州大地尽朝晖
晴空丽日江山锦绣风光美	翔凤腾龙华夏繁荣气象新
庆今朝海晏河清风恬浪静	欣此日民康物阜人寿年丰
去国重来旧雨话添新雨话	出门一笑今年春胜昔年春
群芳吐艳普天同庆春光好	百姓脱贫遍地常怀党泽深
人莫欺心自有造化相辅佑	欲得好命唯有好心能招至
人寿年丰金猴辞岁归帘洞	民安国泰玉羽司晨报晓春
人学愚公万仞山何难移去	世多伯乐千里马不断涌来
仁寿握乾符万国车书会极	中和绵鼎录九天日月齐光
仁政惠民科技田林腾热浪	春风化雨工商市镇谱新篇
日丽风和画出山河如锦绣	翠竹苍松装点神州千岭绿
日丽风和万里江山添锦绣	财丰人健千家宅院展新容
日丽风和秀出山河似锦缎	年丰物阜迎来大地皆春色
日丽彤墀四表光华瞻正朔	云凝宝仗万方歌舞庆同春
日耀东瀛璇室问安云似绮	星回被斗珠宫寄赏物皆春
入世闯关春风得意马蹄疾	兴邦创业祖国贻谋燕翼新
入世贸一槌敲定全球祝贺	达小康廿载告成举国欢欣
瑞雪纷飞九州已兆丰收景	金鸡欢唱四海正逢盛世春
瑞雪飘飘点缀寒梅枝上玉	和风荡荡吹开杨柳叶中金
瑞雪绽红梅君正啸天傲地	劳春织绿草我来放马牧羊
三宝兴旺有缘万众迷转悟	政策英明盛世讴歌唱不完
三恭五敬分兩事事事喜慶	一夜三更分两岁岁岁平安
三阳开泰来处处三春美景	五福骈臻至家家五谷丰登
山川秀美万里神州皆锦绣	社会康宁千秋华夏更繁荣
山堆锦绣神州大地兴伟业	水放涟漪中华江山展宏图
山美水美春光美宏图更美	人新事新时代新传业愈新
山美水美春光美宏图更美	人新事新年代新伟业长新
山笑水笑人人笑谈政策好	天欢地欢家家欢颂生活甜
蛇舞取胜除暴安良政局稳	马到成功兴益除弊国力强
蛇至龙回重开新岁人间景	山欢水笑又度佳节天下春
深化改革万里山河千幅画	高擎旗帜千秋伟业万首歌
深信念佛句句是金刚般若	切愿往生念念显妙明本心
神猴辞岁保驾护航奔富路	金凤迎春昂头振翼唱东风
神州大地春光春色春意浓	举国上下喜报喜讯喜事多
沈水腾龙映日云织千色锦	三阳开泰凌寒梅报九州春
生产争光人民气魄如龙虎	春光可爱祖国江山似画图
生意无边奏曲文禽谐玉管	真机可挹交枝仙萼拥金铃
盛世长春喜看东方腾紫气	神州大治欢呼法制振雄风
盛世多才时雨点红花万树	春光似海东风吹绿柳千条
盛世欢歌峥嵘岁月千秋福	神州喜庆锦绣山河万代春
盛世难逢神驹久有凌云志	青春可再老骥犹怀揽月心
盛世迎春春风得意河山笑	前程似锦锦上添花岁月甜
十亿健儿胸怀奇志兴百业	一代风流手挥彩笔写春秋
十亿神州改革声中辞旧岁	大千世界和平旗下舞春风
十亿神州壮志凌云振鹏翼	万里江山规划宏伟指前程
时代如歌大力弘扬三代表	青春似火全心创建两文明
时尚一新所见原多快意事	春风满面相逢尽是舒心人
时盛岁新河岳高吟诗世界	年丰人寿江山沉醉酒春秋
时泰年丰四季霓裳添异彩	河清海晏九州风物换新颜
世纪更新岁月如歌花似海	风光揽胜山河酿福鸟鸣春
手手互联歌手球手手牵手	心心相印党心民心心连心
淑景舒华绛树含芳承瑞荫	和风协律紫鵷调暖奉祥噰
树石接蓬莱三色矞云成幄	轩窗骞象纬千秋宝箓凝图
水笑山欢人勤春早年年好	花香鸟语国泰民安日日新
说地谈天且以烹茶寻雅趣	怡情悦性还从赏月借春风
四海春临和风吹绿千堤柳	九州福至丽日薰红万径花
四海龙腾盈门喜气临春到	九州蛇舞满面春风报喜来
四海人同新岁新春新世纪	千秋福祝大家大业大中华
四华腾飞九州崛起千家乐	一元复始万众腾欢百业兴
四化争辉五光十色满天彩	百花齐放万紫千红遍地香
四时八月有双节节节顺意	一夜三更分两岁岁岁平安
松牖春回吉霭正临铜晷永	芝庭日丽祥光长拥玉枢高
岁步寅年喜庆团圆同把酒	珠还合浦欢歌一统共迎春
岁届吉羊燕舞莺歌齐祝福	年逢盛世桃红柳绿尽芳菲
岁届龙年好跳龙门题雁塔	身弥虎劲敢凭虎胆占鳌头
岁序更新柳绿桃红征盛世	韶光乍转莺歌燕舞庆丰收
岁月逢春山山岁岁春光美	政策归心行行业业气象新
岁月更新四海春潮风涌浪	国人接力九州捷报电传情
岁月焕新海角天涯皆溢彩	山河铺锦疆南地北总宜春
台湾早归宗好庆中华统一	春光方遍地同呼祖国万岁
太行山下梅花点点春正好	汾河岸上柳枝翩翩景更娇
桃李迎春无边景色来天地	江山入画万缕诗情上笔端
桃李争春满园锦绣迎蜂蝶	江山竞秀万里风光入画图
特区开放天涯景醉天下客	琼岛文明海角人歌海南春
提供警惕众志成城保边疆	加强战备森严壁垒守国门
天马班师捷报频传惊宇宙	仙羊降世宏图再展耀神州
天马行空神州锦绣随驰骋	灵蛇在握世界风云任变迁
天外春回处处河山添异彩	人间岁换家家丝管祝鸿禧
天下皆春长街喜看龙灯舞	人间改岁小院欣闻爆竹鸣
天意顺人心顺党政千帆顺	奥运成世贸成军民万事成
兔窟三营去岁财经已搞活	龙门一跃今年体制再更新
兔卧蓝田万里春风舒碧野	龙腾玉宇千家笑语乐新程
兔跃龙腾瑞盈玉宇天光丽	珠还璧合春满金瓯世纪新
兔走乌飞大舞兔毫辞兔岁	龙腾虎跃敢攀龙角接龙年
团结奋进迎接朝阳新世纪	创业利民广播时代最强音
退田还湖美化中华新环境	栽草种树回归世界大自然
玩玩书画琴棋添几分潇洒	写写诗词歌赋倾一代风流
万里河山绿树丛中皆春色	十亿神州红旗底下尽美景
万马消尘蹄声响彻三千界	五羊衔瑞春意浓于二月花
万枝彩笔绘宏图宏图璀灿	一元复始迎新岁新岁峥嵘
万树飞花八方齐摘丰收果	九天溢彩四海共渡胜利年
万紫千红九州两岸思一统	五光十色四面八方贺三春
望塞北松青柏翠风光正好	喜江南梅红竹绿气象一新
为国争辉万马齐奔改革路	给民造福千帆竞发富春江
文明经商门庭若市春满店	礼貌待客宾至如家暖人心
无限江山同庆神州春永驻	有情岁月相期彼岸燕归来
五载郎曹窃比冯唐犹未老	一官狱吏若逢周勃也称尊
物丰文蔚民安旗扬三代表	日丽风和景泰花簇一锤镰
物华天宝欣闻禹域鸣雏凤	人杰地灵喜看神州起卧龙
西部春浓千年丝路飞花雨	中华世盛万里锦程飘彩旗
西部开发又有春天新故事	中华崛起再书世纪好文章
西电东输万里江山开画卷	南水北调大千世界竞风流
喜接春潮苏大地山青水秀	欣挥翰墨谱神州国泰民安
喜今朝玉兔欢跃九州生色	望明岁金龙奋起万里腾飞
喜庆牛年两制先迎香港还	欢歌兔岁亿民再赞澳门归
喜贴春联副副春联抒壮志	欢燃鞭炮声声鞭炮振豪情
喜值龙年经济腾飞增国力	乐迎盛世人民幸福焕春光
先富后富你富我富大家富	羊多猪多钱多粮多喜事多
现代农民种地种出国外去	当今特产订单订到网中来
香港既归祖国山河添锦绣	澳门又返神州历史更辉煌
消息借流通报道梅花无恙	平安劳传报莫教竹素想思
小康时节丰衣足食千家乐	平世风光绿水青山万象新
小龙辞岁好凭妙手书鹏赋	骏马迎春当显雄才唱大风
小蛇敬业将要退伍还站岗	老马好强不用扬鞭自奋蹄
协气东来禹甸琛球咸辑瑞	和风南被尧阶蓂荚早迎春
心存邪恶烧香拜佛有何益	持身正大不求佛佑佛自佑
心悬日月眷念台胞期一统	情系山河彻思骨肉盼团圆
新纪新春新事新人新气象	好山好水好言好语好心情
新纪新春迎春接福全家福	元旦元年待旦登程万里程
信义公平干部履行三代表	温良礼让人群走向两文明
雄鸡唱韵万户桃符新气象	大地回春群山霞彩富神州
雄鸡喔喔颂尧天邦兴国治	腊狗汪汪歌舜日春暖花开
绣水描山神州大地春常在	藏龙卧虎盛世人家福永存
旭日生辉暖树黄莺歌宛转	春风得意高天紫燕舞翩跹
旭日扬辉崭新世纪呈春色	灵蛇起舞大好河山架彩虹
旭日迎春喜见神州笼紫气	普天同乐共为新纪谱华章
旭日增辉五光十色山河秀	春风送暖万紫千红景象新
学习马列风云万变不转向	深入生活彩笔千秋自芬芳
雪花献瑞五龙鳞甲飞大地	绿酒添欢家人父子庆丰年
雪花献瑞玉龙飞起三百万	绿酒添欢金鼠报来十二时
雪化冰消高山绿涨小溪满	风和日丽故国花繁旧燕来
雪压枝头群山喜见松梅竹	冰溶水里大地争开李杏桃
雪兆丰年且喜丰年逢瑞雪	灯辉佳节每临佳节赏华灯
燕剪秧针绣就寰中千幅锦	莺梭柳线织成天下一家春
扬般若波罗密多利国利民	修净土宝莲正行自度度人
扬鞭跃马四化征途奔万马	乘风破浪五湖四海翻波浪
羊笔如椽描山绘水书春意	马蹄腾雪步韵留香报福音
羊回仙界留下千山芳草绿	猴到人间带来万里艳阳天
羊酒微醺酡颜人共桃符艳	春风乍拂捷报声随爆竹传
羊岁去矣应记取亡羊教训	猴年来兮当发扬金猴精神
阳光普照校园花开春来早	雨露滋润禾苗茁壮叶更绿
阳光普照园丁心坎春意暖	雨露滋润桃李枝头蓓蕾红
样板引路铁路公路路路通	工地为家你家我家家家乐
瑶殿凝庥天上云霞依舜萐	衮衣献寿域中川岳捧尧尊
一个中心狠抓经济兴中国	百年大计广育人才立大功
一九九九喜事频繁歌盛世	二零零零前程似锦看龙飞
一元复始瞩目欣看春来早	万象更新举首敢笑燕归迟
一枝月桂九天梦固成往事	万朵红霞百迭衣再庆新元
以公仆态度对人人人满意	按经济规律办事事事称心
亿万高炉华夏天天除旧貌	百千铁汉神州日日换新颜
亿兆群英再造辉煌跨世纪	万千佳气新呈瑞霭壮山河
益地图开岳贡川珍胪宝笈	丽天文焕豳京邰室溯仙源
银蛇归去盛赞人间春色美	金马奔来争夸祖国气象新
邮局鸿雁一声喜讯三春暖	绿色红娘千里姻缘一线牵
迂道重来百战尚惊臣里梦	出门一笑九衢又吃帝乡尘
鱼跃鹰飞滚滚春潮催改革	月圆花好融融喜气入人家
与时俱进莫凭老眼观天下	上网遨游喜得新知润心田
雨霁天青万紫千红增特色	凤鸣莺啭三通两制促和平
雨润三春披红戴绿千山舞	旗飘四化跃马扬鞭万众忙
玉洁冰清红梅点点催春意	银装素裹瑞雪霏霏兆丰年
玉兔出宫倾慕人间春色美	金龙潜海畅游祖国江山娇
玉兔归宫新春喜气连天外	金龙出海改革波澜动地来
玉兔归时羡慕人间春色美	金龙跃处喜看华夏画图新
玉兔回宫永羡人间春色舞	金龙献岁常牵天际彩云归
玉兔追风喜接澳门归祖国	金龙运气宏开新纪写春光
玉燕翻飞千秋大业千秋世	金蛇狂舞万里春风万里歌
玉宇澄清花香鸟语升平世	金瓯永固马叫人欢幸福春
月异日新不少羊肠成大道	春和景泰好多蜗舍变高楼
悦目赏心神州昌盛山花福	吟诗作对岁序更新景物华
跃马扬鞭四化征途奔万马	扬帆契浪一江春水涌千帆
栽竹栽松竹隐凤凰松隐鹤	培山培水山藏虎豹水藏龙
在圣班师一路凯歌笳鼓竞	雄鸡振翅几声雅唱瑞云生
藻景耀中天瑞启万安殿外	矞云垂北极祥呈长乐宫前
泽沾雨润杨柳依依亲万户	民富物丰财源滚滚涌三江
阿弥陀佛光中极尊佛中之王	念佛法门三根普被殊胜至极
把酒对东风南浦朝霞迎远客	昂头瞻北斗燕山旭日照前程
白发渐催人逐队依然向东院	青春应笑我奔波几日又南台
百花竞盛开日月同辉三代表	万马齐飞跃城乡共建两文明
报晓鸡声拂晓钟声声声悦耳	赏心国事舒心家事事事关情
爆竹辞旧岁玉兔毫光生紫气	华灯照新春金龙捷足步青云
爆竹辞旧岁玉兔毫毛生紫气	华灯迎新春金龙捷足入青云
爆竹庆新春玉兔毫光生紫气	华灯辞旧岁金龙捷足入青云
北斗泰阶平仪凤祥云环锦幄	西池佳气绕衮龙爱日待斑衣
鬓雪更思君十年长梦圆多哈	春风终惠我一代精英战汉城
冰消雪花江山又呈五光十色	冬去春来神州再现百态千姿
彩笔绘宏图个个英姿添异彩	春风吹大地家家欢乐庆新春
彩灯玉树千家同享新春美景	绿酒金樽万户共渡佳节良宵
彩虹铺蓝天喜看桃李香天下	红灯映华发甘洒汗水育新苗
产品百态千姿包罗古今万象	瓷城花团锦簇久享中外盛名
唱回归心曲奋笔劲书祖国颂	迎世纪朝阳而今再赋大风篇
丑岁建奇功香港回归昌国运	寅年兴大业宏图展现壮情怀
除夕作总结心无愧怍情常坦	岁首订规划胸汇敦诚路自宽
创世纪辉煌破浪乘风扬特色	全民臻富庶千红万紫竞芳菲
春风得意东风化雨风靡天下	一马当先万马奔腾马到成功
春风拂人间善良门第春常在	喜雨洒大地忠厚人家喜永存
春风会马年一路凯歌迎盛世	紫气开晴宇满天捷报壮新猷
春光秀色收眼底看人间幸福	春风暖意入襟怀喜盛世太平
春回大地喜庆新春闻鸡起舞	福满人间欣逢盛世跃马扬鞭
春雷鸣大地五湖四海春意浓	红霞映神州万水千山景色美
春色满人间九万里风鹏正举	朝霞遍宇内五千年云雀长鸣
春水泛桃花水面文章呈异彩	东风梳柳絮风光旖旎蕴深情
春水接天长一网收来鱼满载	东风吹地暖千锄种下谷盈仓
催繁花华新枝春风今又鼓荡	历险境受考验多难而后兴邦
大地簇繁花新元盛纪宏图灿	中天呈瑞彩广厦琼楼翰墨香
大地沐春晖万紫千红开盛世	神州沾党泽五湖四海乐丰年
但看百年后无论老少俱成灰	及早作归计求生安养无量寿
党和日同辉昭万里金光大道	民与时俱进建千秋幸福天堂
党政抓科学精研趣理酬大地	工农重生态普种仙桃慰神州
德政布寰中四海翻腾掀巨浪	春雷鸣广宇长空跃动舞银蛇
帝泽即阳春此日均沾立仗马	圣朝无阙事小臣愿作不鸣蝉
发落齿疏幻形凋谢实未足虑	归依三宝得闻佛法欢喜无量
发一片慈心愿度众生达彼岸	照五蕴皆空行深般若观自在
法严政明山清水秀人杰地灵	风正气盛国富民安外强中坚
芳讯问东风宝岛园庭梅放否	阳和舒柳色陆台花木景同春
赋诗奏乐颂扬华夏辉煌业绩	泼墨挥毫描绘祖国锦绣江山
改革出盛果神州处处新气象	开放见华章祖国家家富康强
改革呼声高老凤争鸣雏凤唱	腾飞接力快大龙引导小龙来
改革庆辉煌百族高歌三代表	国家喜昌盛九州齐赞两文明
改革奏凯歌虎跃龙腾强盛景	文明开新局莺歌燕舞太平春
干部是公仆处处为群众着想	人民乃主人事事替祖国分忧
恭祝小龙年锦簇花团呈万象	宏开新玉宇雄伟火箭腾九霄
故宅岁更新卅年京华怜我老	今年春胜昔一堂和气抱孙来
管乐候城共九万里神州日暖	帆樯辽海助两千年盛世龙腾
规范操作安全无忧科技创优	文明生产保障有力效率取胜
海阔天高美鸳鸯比翼奔征程	任重道远好夫妻同心建中华
海是龙故乡龙腾海宇龙光起	春为燕天地燕舞春风燕语新
海是龙故乡龙腾海宇龙兴起	春为花世界花吐春光花盛开
海峡水虽深幸有长虹飞两岸	春节情更切好凭大雁送千封
海宇尘嚣坚甲牧马立国之道	人寰春暖孺子为牛尽我所能
酣墨沾羊毫记载中华创业史	丹青赋春色绘描改革鼎新图
汗马昔曾经年矢及于弹指后	弭貂金愧续天恩重到举头时
好山好水好社会处处风光好	新人新事新风尚行行气象新
红灯如星家家门前飞红溢彩	前程似锦人人心里倒海翻江
洪魔挂降旗重建家园辞虎岁	玉兔开泰运再凭科技奋鹏程
虎年喜虎劲攻关夺隘皆如虎	春节焕春光绣水描山总是春
虎跃龙腾万里长征风光无限	花香鸟语九州大地春色正浓
华光照四海四海皆春春不老	佳节临九州九州同乐乐无穷
华夏五千年经天纬地文明史	新春九万里丰衣足食幸福家
黄鹂鸣翠柳民殷物阜歌盛世	梅花报新春海晏河清倾党恩
挥毫辞旧岁看神州诗天画海	跃马沐春晖创四化伟业丰功
火树银花平添古镇繁华景象	金堂玉宇铸就新街盛世时年
鸡鸣曙日红万里金光辉瑞霭	柳舞春江绿千重锦浪映丹霞
鸡鸣早看天抓住时机求发展	水近先得月紧跟形势上台阶
技术革新多种多样别开生面	潜力挖掘一点一滴各显神通
加强法制教育大兴革命风尚	保障公民权利发扬民主精神
佳节倍思亲厚望台澎同日月	群龙皆起舞欣吟港澳共团圆
接财神皆因勤学勤劳勤思考	迎福星更需敢作敢为敢当先
今日得宽余权借琴棋娱晚景	壮心犹未已但将诗画写情怀
金蛇狂舞去化作苍龙终跃海	天马行空来可记赤兔曾卧沙
近况报人知十载一郎惭圣世	诸君休我惜铨曹比部总天恩
精明机遇多智慧功成求幸福	敦厚是非少勤劳果硕乐康宁
净土法门带业往生方便至极	弥陀宏誓九界全收其大无外
九霄鹏鹏举九霄九霄飞捷报	千里马马奔千里千里荡春风
九域涌新潮四海雄鸡争唱晓	三春辉紫气八方彩凤共朝阳
九州瑞雪飞颂扬斗地征天汉	四海欢潮涌呼唤搏风击浪人
久客又新春五夜每怀臣里梦	一郎仍故我卅年空吃帝乡尘
骏马入马年不待扬鞭快跑马	老牛到牛县到处逢人总吹牛
骏马早迎春一代英豪图改革	黄莺初唱晓千里乐声唱丰收
开特色先河三卷雄文惊日月	奔小康前景九州志士唱春秋
开天辟地劳一辈人老雄心在	创家立业新一代年少志气高
开源节流东西南北方方有利	扬长避短春夏秋冬季季呈祥
凯歌阵阵千里马早过玉门关	春风习习带头羊又登泰山顶
看东方红透一轮旭日应时起	欣法治网通万里和风拂面来
看旧岁银蛇起舞群山增秀色	喜今朝骏马奔驰九州尽春晖
快马加鞭万里长征始于足下	争分夺秒四化宏图绘在今朝
腊酒谢金鸡唱遍神州歌大有	春风催吉犬迈开健步跃高峰
乐吃苦中苦方展出四化宏图	勇登山外山才见得无限风光
立足本职脚踏实地步步前进	放眼未来满怀壮志个个争先
廉风拂禹甸人和政通千秋永	喜讯遍神州岁稔年丰百业兴
两岸共迎春一统前程花似锦	九州同祝酒千秋大业固如磐
龙德正中天四海雍熙符广运	凤城回北斗万邦和协颂平章
龙飞凤舞万里蓝天春晖无限	人欢马叫十亿神州气象万千
龙飞留荡漾祥云映神州壮美	蛇舞带铿锵吉乐催大众图强
龙张十亿帆锁定鹏程操胜券	凤翥千重锦扶摇骏业上青霄
马步牵长风长随远景江山好	牵羊迎盛世依然十里杏花红
卯岁展宏图五湖四海歌大有	辰年逢盛世千村万户讲文明
棉海闪星星天上人间共织锦	花城香朵朵风和日丽庆丰年
民意尚清廉六中精神合民意	人心兴社稷三个代表顺人心
沐灿烂朝阳春光遍洒文明院	迎崭新世纪欢乐长随幸福人
凝命鼎而当阳圣录同符日月	握乾枢以御极泰阶共仰星云
牛年虽过去牛劲更增多奉献	虎岁喜临门虎威大振有精神
普天开景运一片红霞迎旭日	大地转新机万条金线带春光
骑飞虎奋云程广罗八方志士	降蛟龙掌乾坤实现四化宏图
千门迎晓日山川普照春光满	四化趁春风人民咸沾党泽恩
翘首望京华多谢春风常送暖	深情连海宇应凭红豆记相思
人才辈出十亿神州兴旺有期	群芳齐放万里江山美好无限
人崇三代表颗颗红心朝北斗	世仰五星旗滔滔春水向东方
入世破坚冰万里春风催马跃	擎旗兴大业九州特色庆龙飞
入世展新猷天马行空寰宇阔	出门观丽景玉龙嘘气水云深
瑞色布人间锦乡河山添锦绣	春阳照大地光辉节日更光辉
瑞雪飘飘兆江南塞北丰收景	爆竹声声传各族人民欢乐情
三讲送春风民心向党千家富	九州迎绿色国土生金万户康
三讲意如春青春彩焕蓝天下	两思心向日红日辉腾赤县中
山老赏风光总把松涛夸景色	骚人呤雅韵常邀涧水和歌声
善政暖人心经济腾飞闻国际	东风苏大地春光灿烂耀神州
上下几千年历史过客匆匆去	纵横数万里人民江山日日新
蛇岁纳千祥花开梅兰添秀色	春光迎百福鹊啭城乡报佳音
神眼察边疆战士常携千里镜	丹心存祖国人民热爱五星旗
神州呈瑞彩满天捷报迎旭日	大地迎马年一路凯歌壮春风
神州呈异彩琼枝玉树添新果	特色蔚奇观北国南疆涌大潮
盛世拂春风芳草绣堤迎紫气	华年歌善政琼楼锦市展繁荣
盛世千山红祖国扬鞭已跃马	新春万里艳人民折桂再腾龙
盛世喜迎春春风浩浩歌如海	丰年春报喜喜气洋洋福满堂
盛世挹春风芝草灵蛇迎瑞气	丰年歌善政奇山秀水沐朝阳
盛世越千年锦绣河山归一统	新春开元纪辉煌业绩耀三光
十五绘新图喜见山河添异彩	百年开首步要教春风度玉门
世间有三宝九界众生大欢喜	心地常健康昼夜六时恒吉祥
世界国家西部父母夫妻儿女	和平统一开发康寿谐老作为
鼠岁报佳音市场兴旺迎胜利	牛年逢盛世香港回归庆团圆
树雄心创大业为江山添秀色	立壮志写春秋与日月争光辉
税改布春晖乡里人人歌减负	敞仓收硕果农家户户喜增盈
岁庆小龙年反腐倡廉昌国运	史开新世纪爱岗敬业振民魂
天堂地狱自心所造不由外来	清净安乐从学佛来舍此莫由
天作溯前光玉券十华徵锡极	人文观大备瑶签四照见逢原
听党话跟党走实践三个代表	担民忧体民情服务亿万群众
兔岁来矣劝君记取龟兔教训	虎年去也祝您发扬龙虎精神
万里蓝天莺歌燕舞春光无限	千村碧野马叫人欢淑景连绵
万马闯雄关春回大地繁花俏	五羊开玉局旗展东风旭日辉
万象喜回春守信知廉标五德	一元欣复始司晨报午必三鸣
微言释大义春秋有笔公羊传	旧貌换新颜岁月无情司马迁
围箱网布金钩欣吟渔歌情韵	养鲟蟥培蟹鳖巧做水产文章
文笔总多情春联满写新春意	英年须努力壮志早酬少壮时
问如画江山九州壮锦谁铺就	听由衷赞语万里春风党引来
无常就是苦诸法空幻悟者少	岁月不留情百年光阴转眼到
夕照恋青山共兴华夏千秋业	老龄逢盛世同绘江山万里图
西昌火箭升春临南国飞金凤	北阙风云会日照东方起巨龙
喜醇凝喜气天喜地喜人民喜	红烛映红光国红家红事业红
喜东风送暖残雪溶化寒冰解	望大地回春江山添翠芳草生
喜气降人间街头巷尾多歌舞	春风盈海内塞北江南尽画图
喜色最宜人花海人潮平地起	心声常入耳欢歌笑语满天飞
掀改革浪潮神龙载誉回天宇	伴长征号角金蟒迎春降人间
鲜卉挹春风骏马奔腾强国路	神州迎笑语雄狮起舞小康年
祥光照四海四海同春春不老	瑞气满九州九州共乐乐无疆
小龙舞九州龙伴腊归留胜迹	大骥驰千里骥随春到展宏图
校园春意浓朵朵红花向太阳	教师激情涌耿耿丹心育新苗
欣观一九九九四海繁荣富庶	祝愿二零零零五洲安定和平
新春降人间杨柳依依春光美	政策回万户老少盈盈笑声欢
信佛学佛乃是信真理学智慧	正确作人先须爱祖国爱人民
兴庆献春光瑶草金枝迎爱景	大安调玉律朱鸾紫凤叶仙韶
刑已上高官喜看反贪增力度	法冲开黑网欣闻除恶保安宁
旭日鉴忠诚维权果硕三一五	春风播善美普法花馨百万千
旭日丽龙楼瑞气春融珠树回	卿云笼鹤禁祥光晴护玉阶平
萱幄日方长百岁旨甘惭禄薄	云司秋不冷一门桃李觉春多
学习邓小平理论步步阳光道	坚持共产党领导处处幸福门
雪落窗前似扬花点点春正好	霜飘宅后如柳絮片片景更新
雁字报佳音门前碧映珊瑚树	春风传喜讯户外红开富贵花
寅时入虎年十亿人民振虎劲	佳节描春色九州大地荡春潮
银蛇随腊去农业丰收欣在望	金马送春来国民经济喜腾飞
鹰燕舞长空万里江山添淑景	龙蛇腾大泽千年画卷绘宏图
迎春潮转机制开拓市场经济	饮美酒变职能增添企业财源
迎春万里共笙箫喜奏小康曲	匡国千秋同笔墨长描大治图
迎崭新世纪苍龙日暮还行雨	度欢乐晚年老树春深更著花
邮路惠春风片片邮花飞万里	电波传喜讯声声电讯印双心
有天皆丽日天增岁月人增寿	无地不春风春满乾坤福满门
有缘入佛门切莫宝山空手回	能见弥陀佛往生才能有把握
圆满佛法以五戒十善为基础	求生安养视信愿有无为决定
振翅欲冲霄一唱雄鸡声破晓	迎春思试剑三擂战鼓气吞虹
知识海阔勤作舟勤奋任驰驱	科学高峰智为径智坚可攀登
中华大气魄党政同心昌特色	辛巳小龙年军民协力振雄风
众水总朝东今古潮流难抗拒	群星皆拱北台澎士女早归来
珠筴护丰京观化天阊登笈富	铜铺开兑位同文月竁献琛多
转根本法轮三学以毗尼为首	趋菩提正道无我乃般若之门
尊重客观规律反对形而上学	学习辨证思想坚持唯物史观
不靠天不靠地依靠双手绣锦卷	不信神不信鬼坚信马列作指南
长蛇引退退出千家男女满院笑	骏马奔驰驰骋万里江山一片春
车窗似轴屏摄进满眼诗情画意	公路如玉带牵来万里绿水青山
闯关入世竞风流还要登高望远	惩腐倡廉执利剑更须正本清源
春潮涌动绿柳舒枝一笑辞旧岁	青山举首明月开颜三躬迎新年
春风如意引春光照耀满园春色	彩笔随心绘彩锦辉映遍野彩花
春酒绿彩灯红围炉共话长征路	玉梅开瑞雪舞把盏齐歌大有年
大地回春看大好河山皆成锦绣	长天吐瑞喜长恒图祚永放光华
大地回春看大好河山皆成锦锈	长天吐瑞兆长恒国祚永放光华
大觉世尊讲经说法阐明真谛理	九界众生法喜充满仰止沐佛恩
大龙传小龙连年奋进经天行地	老凤带雏凤尽日畅鸣悦耳清心
大中国似蛟龙破雾雄心惊日月	古神州如骏马嘶风豪气壮河山
都来保护母亲河才有一江秀色	若不平衡生态链断无两岸猿声
兜罗佛手转金绳永护坤维日月	优钵昙花开宝界增辉震旦山河
改革花开放花致富花花盈大地	科研果创业果扶贫果果硕神州
广乐奏钧天万国衣冠同瞻旭日	阳春回大地四时橐龠首协温风
虎劲长存救命降魔英烈人人颂	兔年新至扶贫效国赤心户户歌
化成熙皞验风从治媲春孳夏育	祥迓炽昌昭德致符呈乾络坤维
环黼扆瑞焕星云共睹尧襟舜抱	萃贞符禔流帱载长披紧镜朱囊
辉骈宝券晋云阊推策纯常集嘏	庆衍瑶筹赢澥屋阐珍舄弈流褆
鸡豚之畜毋失其时可以致富矣	梨桔之苗广栽其圃安得愁穷哉
坚持四项原则群龙有首生机满	建设两个文明玉宇无尘春意浓
艰若创业风正民心顺干劲充沛	勤俭建国人和国自安先进辈出
减机构裁冗员克文牍旗开得胜	凭优势调结构扬特色马到成功
建立沿海特区已使东南花似锦	吹响进军号角再教西北土成金
讲科学破迷信莫让愚氓误自己	批法轮铲毒根严防邪教害人民
金鸡报晓续金猴前路金光万丈	福地来风增福气新春福运满门
金龙狂舞舞腾九州华夏千般暖	骏马奔驰驰骋万里江山一片春
金蛇狂舞舞动千年古国两面旗	骏马奔驰驰骋万里江山一片春
金蛇狂舞舞动千年古国千年情	骏马奔驰驰骋万里江山万里新
金蛇喜庆庆贺九州方圆百业举	骏马奔驰驰骋万里江山一片春
景福集璇宫亿万斯年永登仁寿	慈云辉宝殿千八百国莫不尊亲
九重敷敛范陈箕曼羡蕃厘共锡	万国会归光戴斗荡平轨路同遵
巨龙腾飞飞越十亿神州八方土	骏马奔驰驰骋万里江山一片春
巨手回天喜四化业绩彪炳史册	群贤向党看万里江山再展宏图
科技振兴兴国兴业山河年年壮	勤劳致富富家富民岁月日日新
立德立功把诚心爱心奉献社会	求实求是怀正气豪气搏击人生
丽韶景于履端璧带风微翔彩燕	耀春辉于复旦帘衣昼静响铜龙
两岸民情欢迎两地同心行两制	三通众望赢得三阳交泰贺三春
龙携华夏腾飞飞起玉龙三百万	蛇伴新春狂舞舞来银蛇数千条
洛筹福纪庆洪延象叶居中建五	乾协祥符徵顺叙功牟则大函三
漫天瑞雪飘飘洒洒献舞开放日	遍地烟花噼噼叭叭讴歌改革年
梅吐蕊柳抽芽老少边穷春正好	地生金人益寿东西南北景常新
妙谛证拈花万户千门皆成宝地	明心同指月十洲三岛并现金光
民意顺国运兴四海讴歌称盛世	春风和日色丽九州景物换新颜
谋生莫怕无门不靠神仙靠自己	下岗应该有路当凭智慧凭勤劳
普法九州喜庆九州大圣齐天乐	维权百姓欢娱百姓平民遍地歌
企务公开廉字为本家兴企业兴	民主管理实字出发事顺民心顺
千百年风雨飘摇国恨家恨尽泯	五十载沧桑变革日新月异当歌
清廉如春雨润禾可使万民富裕	腐败若害虫蚀木能教大厦倾颓
三壶景象驻恒春扣砌环迎瑾戬	六幕光华徵复旦彤宸茂集繁祺
山坡植树河岸造林青峰环绿水	街道种花社区栽草闹市荡春潮
山新水美万户千家都夸政策好	国富民强南天北地同庆丰收乐
申奥成入世毕得胜鼓响风云天	人心聚宏图展赤兔马奔金光道
施德政顺民心春回大地千家暖	倡文明除陋习光照人间万象新
树新风学习七一讲话与时俱进	催骏马实践三个代表跟党同行
顺时宣象咸宜瑞履青阳开左个	懋德凝禔孔厚祥延紫气卫中垣
岁又更新喜时雨宜人春风惠我	民方致富幸文明化俗科技兴邦
岁属龙龙布雨雨顺风调呈稔岁	春迎燕燕衔花花团锦簇贺新春
堂堂正正做人纵使清贫亦富贵	认认真真干事虽无壮举也英雄
桃红柳绿正三春丽日风光无限	燕舞莺歌是万顷碧空生意盎然
天上花地上花花团锦簇亮中华	上山虎下山虎虎虎生风闯九州
天上花地上花花团锦簇亮中华	东北风西北风风来神州暖春梦
天上花地上花花团锦簇亮中华	新年欢旧年欢欢聚满堂度新年
贴心伴侣互帮互助共奔小康路	恩爱夫妻同心同德齐创幸福家
万里锦绣河山靠十亿人民装点	八旬峥嵘岁月赖三代领袖导航
万马奔腾一马当先好马脱缰马	千军抖擞三军最勇神军解放军
位育本中和曰旦曰明至诚丕应	寅清浮上下亦临亦保敬德昭宣
我佛如来见一切众生皆大欢喜	弥陀慈父建极乐世界何等庄严
舞志士激雄心歌来红日千门晓	除邪氛张正气攀上碧桃四海春
西拜佛东拜神妇女烧香忙碌碌	着新衣戴新帽儿童拍手笑呵呵
昔日保卫祖国光荣传统放光芒	今朝发展经济创新意识结硕果
喜看南国花繁红透洞庭波映日	紧握楚天笔健才追潘岳气凌云
想当日家无隔夜粮苦嫦娥奔月	看今朝柜有陈年酿香玉帝思凡
小康有望老百姓全凭三个代表	大地回春新千年更看九州风云
修道修仙先须修身身为道之本	信佛学佛不可离心心是佛之源
旭临鳷鵲初升华祝腾欢连月窟	仗转蓬莱徐引宸居茂对洽春台
瑶光东指为春瑞启扶桑齐七政	黄道左旋而运颂胪戴斗供三阶
亿万龄锡羡延洪保定自天孔固	三千界重熙洊洽祥和与物同春
银蛇舞江城美千帆竞发辞旧岁	黄鹤飞楚地阔万物峥嵘迎新春
迎春接福笑逐颜开庆合家团聚	进喜添财神怡心旷看举国欢腾
玉阶晓拥珩璜天上庆云移宝扇	金阙遥趋剑佩春来瑞气满瑶池
招南北东西杰才绘我神州特色	集古今中外精粹写吾盛世新篇
振兴伟大中华道路驰骋千里马	迎接崭新世纪人民团结一条心
雉尾云移看玉烛光中星扶华盖	螭头香动听金铃声里风展春旗
重霄日月烛升恒景云祥开久照	八表山川徵乐寿昌期福集新韶
珠囊晷纬迓休徵福界垣昭太乙	玉烛年华彰瑞应昌辰化溥由庚
专业承包百业兴隆家家有存款	联产计酬五谷丰登户户有余粮
壮丽北京五星托五环申奥惊喜	少年中国三代启三步入世腾飞
八亿神州扬鞭催马闯入世金蛇腾飞	全国人民齐心协力干四化马到成功
登世贸天揽奥运星举目神州春色满	奋共青志扬民族气捧心代表画图新
风送银蛇虎啸龙吟河清海晏誉华夏	雪迎金马莺歌燕舞柳暗花明称神州
观音菩萨大慈大悲千处祈求千处应	千手如来随处化身苦海常作渡人舟
红梅傲雪云蒸霞蔚姹紫嫣红春生韵	绿柳经霜芝郁蕙馨兰薰桂馥露凝香
激浊扬清清则开朗朗朗乾坤昭盛世	脱贫致富富而思源源源雨露润苍生
巨龙凌空雄狮拜地爆竹声声辞旧岁	紫燕展翅绿柳吐丝梅花朵朵迎新春
劳苦园丁春风化雨今日遍栽桃李树	辛勤学子铁杵磨针他年都是栋梁材
立党为公执政为民盛世践行三代表	修身以德兴邦以法神州唱响两文明
灵蛇献智珠风云岁月却见一枝独秀	神马踏飞燕锦绣山河再看万木争荣
柳绿桃红山清水秀万里神州春不老	年丰物阜国泰民安千秋岁月乐无穷
龙贺岁凤还巢满眼春光处处新元景	鹊登枝梅吐蕊千秋大业时时锦上花
龙游东海马放南山龙马精神传万代	虎啸西冈牛耕北国虎牛威力震千秋
绿抹柳梢红燃花萼燕舞莺歌相比美	春临世界喜降人间龙腾虎跃竞争先
农村兴旺同庆丰收谷似金山棉似海	城市繁荣共迎新岁车如流水马如龙
普天开元壬日鼎香传癸铭铭记发达	大地回春午夜钟声报未来来年如意
勤廉并行作风转变民安国泰千秋福	法德齐治正气弘扬地久天长四海春
清风循法明月依章塑就民心春色丽	碧海迎新苍山辞旧铸成国鼎日光明
庆佳节女儿平安回故里盼事事如意	过新年父母健康在家中望天天开心
申奥成功入世成功频传捷报惊寰宇	迎难而上乘势而上再显雄风铸国魂
申奥功成入世关通一年好景蛇辞岁	兴邦业举富民旗展万里雄图马跃春
时也逢春法也逢春万里中华革旧貌	民尤思治党尤思治千秋盛世展新姿
世纪坛前火树银花百年奥运圆美梦	黄浦江畔欢歌笑语五彩唐装竞风流
岁月峥嵘应知花甲易屈指珍惜少壮	江山锦绣乐与赤子同存心服务人民
桃红柳绿燕舞莺歌爆竹烟花迎盛世	海晏河清年丰人寿凯歌曼舞庆新春
天马行空足踏祥云背驮贺仪来华夏	春光送暖风传喜讯花献征途映帅旗
为官应有根凭德凭才莫凭弄虚作假	秉政当无弊拒谗拒贿勿拒激浊扬清
伟略宏图扶世安邦大地生辉皆特色	和风丽日沧桑正道神州昌盛尽新颜
五羊献穗六合同春此处仙人常驻足	八骏驰原九州共庆当前盛世自开心
五业并举八方奋进到底人民政府好	四处祝捷万马奔腾还是社会主义强
西去阳关玉局宏开辉煌事业辉煌路	南观楚地鸿图铺展锦绣人文锦绣天
行空浮游揭奥运金蛇狂舞欢歌盛世	入世驰骋踏环球万马奔腾独领风骚
雪照梅红经冬娇娇娇娆枝柯吐新蕊	花映柳绿迎春郁郁郁馥蓓蕾露暗香
依法治国从严治党创优环境求发展	照章办事按质办差改善作风显效能
运筹帷幄纬地经天奔腾喜托嘶风马	装点河山争分夺秒起舞欣闻报晓鸡
执法秉公公生正气气贯长虹昭日月	爱民送暖暖似春风风行大地秀河山
执法树尊严定教浪子回头贪官罢手	为民谋利益喜有清风扑面明月澄怀
中原重笔青史改革潮头定九霄龙腾	华夏迭出俊才开放阵前当万里鹏飞
走近黑板手臂一挥忠诚从指尖流出	向着未来心劳不辍希望在爱里繁荣
祖国在心金杯在手张张笑脸迎新岁	春光入眼瑞气入杯处处欢歌颂小康
八亿神州扬鞭催马闯入世金蛇腾飞	全国人民齐心协力干四化马到成功
登世贸天揽奥运星举目神州春色满	奋共青志扬民族气捧心代表画图新
风送银蛇虎啸龙吟河清海晏誉华夏	雪迎金马莺歌燕舞柳暗花明称神州
观音菩萨大慈大悲千处祈求千处应	千手如来随处化身苦海常作渡人舟
红梅傲雪云蒸霞蔚姹紫嫣红春生韵	绿柳经霜芝郁蕙馨兰薰桂馥露凝香
激浊扬清清则开朗朗朗乾坤昭盛世	脱贫致富富而思源源源雨露润苍生
巨龙凌空雄狮拜地爆竹声声辞旧岁	紫燕展翅绿柳吐丝梅花朵朵迎新春
劳苦园丁春风化雨今日遍栽桃李树	辛勤学子铁杵磨针他年都是栋梁材
立党为公执政为民盛世践行三代表	修身以德兴邦以法神州唱响两文明
灵蛇献智珠风云岁月却见一枝独秀	神马踏飞燕锦绣山河再看万木争荣
柳绿桃红山清水秀万里神州春不老	年丰物阜国泰民安千秋岁月乐无穷
龙贺岁凤还巢满眼春光处处新元景	鹊登枝梅吐蕊千秋大业时时锦上花
龙游东海马放南山龙马精神传万代	虎啸西冈牛耕北国虎牛威力震千秋
绿抹柳梢红燃花萼燕舞莺歌相比美	春临世界喜降人间龙腾虎跃竞争先
农村兴旺同庆丰收谷似金山棉似海	城市繁荣共迎新岁车如流水马如龙
普天开元壬日鼎香传癸铭铭记发达	大地回春午夜钟声报未来来年如意
勤廉并行作风转变民安国泰千秋福	法德齐治正气弘扬地久天长四海春
清风循法明月依章塑就民心春色丽	碧海迎新苍山辞旧铸成国鼎日光明
庆佳节女儿平安回故里盼事事如意	过新年父母健康在家中望天天开心
申奥成功入世成功频传捷报惊寰宇	迎难而上乘势而上再显雄风铸国魂
申奥功成入世关通一年好景蛇辞岁	兴邦业举富民旗展万里雄图马跃春
时也逢春法也逢春万里中华革旧貌	民尤思治党尤思治千秋盛世展新姿
世纪坛前火树银花百年奥运圆美梦	黄浦江畔欢歌笑语五彩唐装竞风流
岁月峥嵘应知花甲易屈指珍惜少壮	江山锦绣乐与赤子同存心服务人民
桃红柳绿燕舞莺歌爆竹烟花迎盛世	海晏河清年丰人寿凯歌曼舞庆新春
天马行空足踏祥云背驮贺仪来华夏	春光送暖风传喜讯花献征途映帅旗
为官应有根凭德凭才莫凭弄虚作假	秉政当无弊拒谗拒贿勿拒激浊扬清
伟略宏图扶世安邦大地生辉皆特色	和风丽日沧桑正道神州昌盛尽新颜
五羊献穗六合同春此处仙人常驻足	八骏驰原九州共庆当前盛世自开心
五业并举八方奋进到底人民政府好	四处祝捷万马奔腾还是社会主义强
西去阳关玉局宏开辉煌事业辉煌路	南观楚地鸿图铺展锦绣人文锦绣天
行空浮游揭奥运金蛇狂舞欢歌盛世	入世驰骋踏环球万马奔腾独领风骚
雪照梅红经冬娇娇娇娆枝柯吐新蕊	花映柳绿迎春郁郁郁馥蓓蕾露暗香
依法治国从严治党创优环境求发展	照章办事按质办差改善作风显效能
运筹帷幄纬地经天奔腾喜托嘶风马	装点河山争分夺秒起舞欣闻报晓鸡
执法秉公公生正气气贯长虹昭日月	爱民送暖暖似春风风行大地秀河山
执法树尊严定教浪子回头贪官罢手	为民谋利益喜有清风扑面明月澄怀
中原重笔青史改革潮头定九霄龙腾	华夏迭出俊才开放阵前当万里鹏飞
走近黑板手臂一挥忠诚从指尖流出	向着未来心劳不辍希望在爱里繁荣
祖国在心金杯在手张张笑脸迎新岁	春光入眼瑞气入杯处处欢歌颂小康
奥运定佳期炎黄子孙庆圆梦北京你好	世贸开新局华夏儿女迎挑战祖国我来
长空五光十色除夕猴在山重享齐天乐	大地万紫千红迎春鸡报晓高唱东方红
大地早回春处处春光好莫把青春负了	龙年多造福人人福中过坐亨清福行吗
国事已变更冉冉春回问东君犹名皇否	天心早眷顾眈眈虎视嗟西虏其奈我何
金猴献礼家家顺利玉燕嬉春九州铺锦	喜鹊闹春事事吉祥金猴贺岁一国呈祥
净土法门三根普被大畅如来度生胸怀	弥陀弘誓九界全收唯依念佛得度生死
九界众生离求生净土上不能圆成佛道	十方诸佛舍念佛法门下不能普利群萌
酒绿灯红今夜连双岁愿世间岁岁如意	人勤春早明朝又一年祝天下年年称心
热血荐轩辕苦干兴邦莫使青丝空染雪	雄心齐岱岳笃行建业定教黄土早成金
上上下下男男女女老老少少都添一岁	家家户户说说笑笑欢欢喜喜均过新年
申奥冲杯入世骏马奔腾喜庆花开三度	改革开放搞活金蛇飞舞欢欣泽被九州
深信因果律今生命运来自前生所种因	切莫信鬼神欲转孬命唯有努力多修心
天堑寄豪情紧握钢枪肃立军威尽职守	桥头历风雨疏通车辆调频血脉护江城
兔去龙来四海喜金瓯共祝三通图一统	花明柳暗九州歌宝鼎同期两制乐千秋
维修保养慢工细活精益求精创新创效	技改创新能人巧匠爱岗敬业多劳多得
忆旧岁牛劲冲霄汉神鞭一指神州巨变	看今朝虎威壮中华众志成城经济腾飞
八秩铸丰碑河山披锦绣九州春色来天地	六中开盛景党政竞辉煌万里风光入画图
传情达意弘扬美好河山社会主义主旋律	泼墨挥毫歌颂崭新世纪中华民族时代风
国昌盛政通和民丰物阜巨龙腾飞惊寰宇	四海欢五湖笑九州同庆华夏江山成一统
立法司法執法國法嚴明恒衡互輔期長治	黨風政風民風家風正派敬淨相依可久安
丽日卷云帘待燕子南来好商量一年春事	惊雷开蛰宇看东风天降重装点万里河山
人生重品德品德塑人格人格造就人生路	智士出策谋策谋依智能智能育成智士才
无私无畏方可做好官做大官做大大好事	有情有义才能得人心做舵手传千古美名
无我无人无众生无寿者四无能令心常净	如露如电如梦幻如泡影行者应作如是观
心铭三代表献赤子丹心跟党齐奔开富路	力创两文明展青春活力与时俱进跃新阶
新中国如舸舰斩浪劈风启后承前三舵手	古神州似蛟龙腾空破雾开来继往一精神
玉兔走金鸟飞走走飞飞飞向春光明媚处	雄狮欢巨龙舞欢欢舞舞舞出华夏壮美丽
展青春风采做四有新人努力遵循三代表	跨世纪征程怀九天壮志齐心建设两文明
整队及书生忆六月青沙臣命轻于挥汗日	论功分战将愧一枝翠羽天恩重到举头时
著手成春多凭三代丰功百年史迹翻新叶	与时俱进满载九州生气万马蹄声起壮图
除旧更新兴邦五秩昌明际雨润红桃传喜讯	务真求稳创业千功显赫时风拂绿柳送佳音
大地沫春辉迎来蛇舞灵珠经济腾飞通世贸	星沙添异彩喜看鹰扬金榜人文蔚起动潇湘
驾飞船遨游宇宙举金杯和天地共饮辞岁酒	乘火箭漫步银河吹玉笛与日月同唱迎春歌
讲坛施雨露师爱拳拳超母爱遍地桃红李白	朱笔播春风心泉汩汩化甘泉满园桂馥兰芬
庆新年千村鸣炮万户撰联喜炮春联醒耳目	扬正气九野响雷兆民击鼓惊雷警鼓壮河山
人尽才地献宝百业争效益共同开拓新局面	风送暖鸟传情万类竞自由一起装扮好河山
日轮西去娑婆光阴有限百年寿命转眼即到	净主安养极乐寿命无穷只此一生即成佛道
入世国事家事大事喜事国家大事万事如意	民庆马年骑马迎马接马人欢马跃马到成功
生肖十二多富有迎马接羊它来我往世人里	岁月三千太匆忙争分夺秒箭去船归天地间
时雨一犁遍地禾苗争茁壮喜迎已卯千家富	春风几度满园桃李斗芳菲极目江山万木荣
巳岁不寻常欣瞻祖国繁荣处处管弦歌盛世	蛇年真雅化喜见城乡活跃家家诗酒贺新年
天接云涛地连芳草改革风潮遍及大江南北	情同骨肉根系炎黄团圆心愿波延海峡东西
笑则迎春喜则入世调整规章振兴华夏经济	法以治国德以为民保持廉洁弘扬公仆精神
因名法藏誓愿宏深所建极乐国净妙世无双	果号弥陀慈悲广大九品度众生威德无穷极
圆申奥好梦又嫌喜期太遥六年怎不一年过	展入世宏图而乐强国将近三步何能两步行
斗非典截长江驾飞船遨游似椽羊毫又写巨著	披铠甲擂战鼓乘东风腾跃如意金箍再辟新天
借东风劲军劲旅愈战愈勇先进设备誓拿国优	迎改制新局新企再接再历科学管理争创精品
梅红竹翠溢彩流霞装点锦绣河山迎接新世纪	政善人和强民富国创造辉煌业绩振兴大中华
如画江山如歌岁月如意人生富裕蓝图众手绘	同心改革同德振兴同谋发展小康硕果大家尝
三江呈瑞五岳献珍十亿炎黄兴改革春潮浩荡	四海朝阳六合庆典千秋华夏颂国策歌舞升平
申奥扬眉入世争雄足球圆梦喜事桩桩强国力	促农迈步航天斗艳科技兴邦丰碑座座快民心
桃花春水遍天涯寄语武陵人于今可改秦衣服	铁马金戈回地轴吟诗锦城客此后休嗟蜀道难
喜蛇岁三喜临九州入世贸办奥运进军世足赛	望马年众望盼一统强国力收台湾扬我国家威
喜蛇岁三喜临九州入世贸办奥运进军世足赛	望马年众望归一心强国力富人民扬我国家威
以法治国以德治国法德齐施九州有望臻长治	唯工安民唯农安民工农并举四海无忧庆久安
看世间苦海无边唯有放下一切信愿持名求往生	信佛法迷津有岸朝夕勤撑宝筏净心念佛到彼岸
龙人兴水利旱涝双防座座丰碑载德载功歌夏禹	文化下农村贫愚两治行行足迹送书送戏布春晖
内兴国运外振邦声天马任行空伟绩千秋昭日月	下察民情上谋政务风鹏思奋翮华龄八秩寿山河
南湖树帜纬地径天崛起大中华三代丰功标史册	北极导航承前启后腾飞新世纪千秋骏业步鹏程
入世复关经贸涌商潮趋利避害黄河扬子双龙舞	迎春跃马改革添虎翼搏雨追风西部东方两凤飞
上岗理当爱岗克已奉公自有正气如虹真情似火	迎春更要惜春闻鸡起舞誓为人生添彩事业增辉
申奥成功入世告捷国足出亚洲新世纪赢新胜利	香港回归澳门收复台湾期统一大中华庆大团圆
申奥胜利入世成功九域庆明时成绩辉煌辞旧岁	国运昌隆元阳复始万民歌德政宏图奋展迓新年
修良德精良术施良方专起沉疴方可称妙手天使	扬正气循正规蹈正矩永留本色才不负仁心白衣
贺新岁喜迎盛会举国谋大事民族复兴迈向高起点	绘宏图紧抓良机全民建小康国家强盛开创新纪元
年虽难过依然得过出手分些压岁钱岁岁行情相似	岁固必辞实在惊辞开心用点延年菜年年味道不同
庆八秩诞辰学七一讲话万户千家百世讴歌三代表	贺六中全会绘十五宏图九州四海亿民建设两文明
蛇献肝胆显效申办成功万民喜悦同心协力奥运会	马驮足球飞奔冲出亚洲举国欢腾翘首以待世界杯
社会公德职业道德家庭美德文明新风似繁花吐艳	夫妻爱情长幼亲情邻里友情优良传统如百宝藏身
与各洲建交和时代同行跃虎腾龙轨接全球圆富梦	向西部要宝朝北方送水掀天揭地图开新纪竞风流
春雷惊蛰惩贪官凝党心顺民意欢呼七一精神三代表	天马行空施廉政扬公德清世风落实六中决定八坚持
镰运锤挥万古江山开盛世羊岁去矣应记取亡羊教训	龙骧虎奋九州儿女创殊荣猴年来兮当发扬金猴精神
山歌民歌流行歌江河共长天一歌歌颂北京申奥取胜	茶话酒话家常话政府与大众同话话谈国人入世生机
天祥小组遍江城济困扶贫雪中送炭黎民倍感党恩暖	科技专车满乡下传经献宝锦上添花冬日唯知春意浓
国逢盛世负五千仞黄泥土烧秦砖汉瓦独撑起乾坤大殿	马踏春风携亿万颗赤子心作唐诗清联绝唱出日月长天
猴去鸡来胜利年终迎胜利猴年赞金猴棒奋千钧除腐败	莺歌燕舞腾飞岁席再腾飞世人歌盛世家兴万富民康宁
入关报捷申奥成功足球出线元首聚华虎步龙骧新世纪	植树治沙退田还草西气东输南源北调天蓝海碧好河山
喜事多多入世胜利申奥成功足球出线银蛇昂首千秋史	暖风浩浩西北腾龙东南起凤三峡描春金马奋蹄万里程
智探风险慎待风险敢闯风险勇担风险风险与机遇同在	鼓励竞争参与竞争有序竞争公平竞争竞争和发展共存
贸易组织入世奥运喜迁首都世界和平炎黄子孙当为马首	经济政策出台足球崭露头角家国兴盛华夏儿女奋起龙头
学孔繁森清清白白两袖清风当人民公仆续写志敏清贫赋	效焦裕禄正正堂堂一生正义做干部楷模再吟天祥正气歌
忆去年峥嵘岁月双喜临门华夏扬眉申奥入世终于结胜果	看今朝风流人物一马当先国脚逐鹿亚军冠军不再是美梦
百川长流百船竞发观八方佳宾心满意足五湖四海承前启后	万物兴盛万马奔驰望九州大地风调雨顺一国两制继往开来
放千枚爆竹把穷鬼轰开数年来被这小奴才扰累俺一双空手	烧三支高香将财神请进从今后愿你老夫子保佑我十万缠腰
改革甘霖润物苏廿余载高原着绿大漠披青万树碧梧皆引凤	开发春雷惊蛰起一霎时瀚海涛翻藏江浪滚千群赤鲤即成龙
故国同春色归来直欲砚池溟渤笔昆仑裁天样大旗横书汉字	民权如海潮暴发何难郡县欧非城美奥把地球员幅竟入版图
花开艺苑惠风和看此日桥头舞燕柳岸啼莺彩电红灯争照美	春满商场生意好庆今朝树上摇钱盆中聚宝琼楼玉宇更藏娇
申奥成功国足出线顺利入世祖国内外别开生面共度丰收年	科技领先三讲落实西部开发华夏上下更跃层楼喜庆十六大
小桥连四海闻高山献宝秀水腾龙红日凛光华万众欢呼三代表	皓月照千秋看奇石穿空名花弄影清风弘正气普天同庆两文明
七月逢双庆月头党寿诞月中申奥成寰宇友邦接二连三飞贺电	一秋破两关秋首大运赢秋尾足球捷中华健将争先恐后展雄风
健身潜秘诀出门喜进门欢老当益壮潇洒自然快活神仙春岁福	长寿有良方今日操明日舞病且宽舒恩怨无忌逍遥伴侣夕阳红
北国炎炎腾热浪京华烈烈动欢声看看看拳拳丹心欲与月飞飞	奥宇沉沉起惊雷运祚隆隆祝东风盼盼盼耿耿星河初显曙微微
武汉为绿色通衢晴川历历芳草萋萋党风促市风铺锦春风天地满	长江乃黄金水道汽笛悠悠烟波渺渺后浪推前浪淘沙大浪古今同
山中异兽日无衣夜无被不无快乐年年岁岁潇潇洒洒皆因环保法	笼里珍禽食有肉疾有医却有悲伤暮暮朝朝抗抗争争只为自由权
亚太高峰会沪城几许热情几番礼遇话资源筹长策九重春色萃胜地	白黄肤体着华服十分风采十足精神访贤主晤嘉宾万束焰花度芳辰
西疆接轨上海迎宾入世弄潮夺金申奥蛇岁运蛇矛内政外交齐奏凯	忠党爱民倡廉惩腐安邦反恐重教兴科马年加马力奋蹄昂首再长征
龙马精神办奥运马到成功踏足杯快马加鞭闯世贸马踏飞燕天马行空	宝马献瑞盼富国人欢马啸望强民跃马扬鞭超先进一马当先万马奔腾
致富靠辛勤脚踏九州胸怀四海鼓全身勇气闯百个难关旗开处必能奏凯	发财赖干劲眼观六路耳听八方乘万里长风破千重巨浪马到时定可成功
希望寄马年马驮希望奔腾来未来更好与时俱进再谱新篇厚礼献迎十六大	丰收话蛇岁蛇献丰收载舞去过去真优向上奋追频传捷报雄风飞越两千年
看万山红遍层林尽染漫红碧透百舸争流鹰击长空鱼翔浅底万类霜天风景这边独好	望长城内外悬崖百丈千里冰封万里雪飘山舞银蛇原驰腊象红装素裹江山如此多娇
马越雄关经济振兴续开新态势高频率全功能与时俱进齐讴三步主题歌不分汉满蒙回藏	春臻上国和平发展再做大文章多层次宽领域联袂并行同奏五洲交响曲何论亚非拉美欧
金蛇起舞大地播春九天晓日铺五色云霞五岳峥嵘江山更新正气驱邪气浩然一幅兴邦画	骏马疾行山河增秀万里春潮绘八方锦绣九州激荡春光伊始今年胜去年伟哉千篇改革诗
金蛇吐蕊百花苏醒阳春有脚送来五谷丰登百业全兴五光十色江山一统中华万里山河壮	骏马带风万物生辉甘露无声绣出三春淑景九州鼎盛万紫千红德政两全神州千般风景新
问时雨春风春在哪里承五中启六中群芳竞艳九域飘香入世迎春春浩浩春海春光春藏心底	看欢天喜地喜从何来举两步登三步快马催鞭万方喝彩出征报喜喜洋洋喜人喜事喜上眉梢
金蛇迤逦游一路高歌送冬去长城欲抬头长江百折归福海南疆北国齐贺华夏千秋盛事中华儿女昂首盼望奥运火	骏马矫捷行四蹄欢唱迎春来黄山早扬眉黄河九曲驾祥云东海西域共展神州万古雄旗炎黄子孙阔步进入世界杯
人文武汉古郡乾坤存胜迹三楚风骚精英荟萃教育领先黄鹤白云萦学府人才重镇万马奔腾驰万里优势发挥见仁见智	科技江城名牌战场抖神威两区雅韵光谷峥嵘高新居上青山碧水拥尖端资讯前锋千龙起舞竞千霓潜能驱动逾远逾宽
邀五环圆梦庆九州入世赖两制补天借四化兴邦遵六中号令沐七星光彩巍巍龙族岂无好戏连台别昨日动千军又蘸春潮书杰作	拥一党领航喜百舸争流促三通填海观八荒铺锦展十面雄威护万里江山凛凛华人更有胜机在握看今朝凝众志再凭马力创新功
党庆八十慈萱北斗启航南湖树帜乘风破浪倒三山更喜三中全会经济成龙舞东南看南沙群岛映港澳明珠南斗摘星临太空探密南洪北调送甘泉时雨妍玉门杨柳绿色长青荣北阙最重南巡留语悬凤律金钟相伴楚天高处黄鹤白云云绕碧空成画景催科技腾飞水活源头富神州审时度势先从小康追玉兔	人歌廿一世纪东风和煦西部迎春跃马扬鞭奔四化精描十五蓝图筑巢引凤落西北窥西夏王陵耸冰封瑞塔西疆怀古咏燕赵豪情西气东输取热土流金有戈壁宝藏资源丰富出东城巧合西路誓师建龙滩电站远吞秦岭横穿银川青海海连广宇耀祥光赖人文蔚起国立强林襟世贸革故鼎新再沐旭日迎朝辉
