金牛贺岁	玉鼠回宫
金鸡报晓	神犬驱邪
闻鸡起舞	放犬缉私
猴扫妖氛	岁纳祯祥
猴桃献寿	鸟语迎春
龙腾虎啸	腊尽春回
丹凤来仪	金鸡报晓
猴岁呈祥	鸡年纳福
鸡鸣晓旦	燕舞阳春
鹊送喜报	鸡传佳音
神猴辞岁	金凤迎春
雄鸡唱韵	大地回春
藏龙卧虎	人杰地灵
况逢龙岁	绝胜鹏搏
百花齐放	万马奔腾
彩云追月	骏马迎春
小龙辞岁	骏马迎春
竹梅品格	龙马精神
金龙述职	银蛇报春
龙飞蛇舞	燕语莺歌
丙辉瑞应	子庶丰登
丙名世德	子夜凯旋
丙年春满	子夜灯红
丙年凤仪	子夜钟鸣
丙年兴旺	子民腾欢
人喜盛世	鼠兆丰年
子年人瑞	丙岁春温
子年润泽	丙火兴隆
子孙奋发	丙火辉煌
子夜为鼠	丑时属牛
马驰万里	羊恋千山
羊肥马壮	国富民丰
羊迎大吉	岁纳永康
云边雁断	陇上羊归
布谷迎春叫	牵牛接福来
草发黄牛乐	春新紫燕歌
草绿黄牛卧	松青白鹤栖
草暖青牛卧	松高白鹤眠
丑时春入户	牛岁福临门
春催布谷鸟	人效拓荒牛
春来紫燕舞	节到黄牛忙
春丽牛逢草	月明马识途
春暖青牛跃	山高碧水流
春新牛得草	世盛国幅辉
催春布谷叫	报喜牵牛开
丰稔黄牛志	富强赤子心
欢度新春节	高歌小放牛
黄牛耕碧野	白首乐红楼
黄牛耕九野	白马战疆场
黄牛耕绿野	猛虎啸青山
黄牛耕沃野	紫气笼新春
将军爱战马	农夫喜黄牛
金牛奔盛世	紫燕舞新春
客岁送金鼠	今年买铁牛
牛背飘春曲	鹊舌报福音
牛耕芳草地	鹊报吉祥年
牛耕千野绿	鹊闹一庭春
牛开丰稔景	燕舞艳阳天
牛铃飘翠岭	燕语暖春风
牛舞丰收岁	鸟鸣幸福春
牵牛花报喜	布谷鸟催春
人逢如意事	牛舞艳阳春
人勤春来早	草发牛更肥
瑞雪迎春到	金牛贺岁来
深恩红赤日	忠实老黄牛
鼠趁三更去	牛驮五福来
鼠遁春风至	牛携喜气来
鼠去粮满囤	牛来地生金
岁首春到户	牛年福满门
夜草能肥马	生刍可壮牛
乙朗芳草地	丑待吉祥年
莺舞池边柳	牛耕陌上春
愿效黄牛力	尽抒赤子情
紫燕寻旧主	金牛舞新春
金鸡歌国泰	义犬报民安
金鸡交好卷	黄犬送佳音
犬守平安日	梅开如意春
戍日耀吉瑞	狗年臻福祥
百业农为本	万灵猴占先
金猴方启岁	绿柳又催春
鸟语喧花果	猴声啼水帘
申年梅献瑞	猴岁雪兆丰
羊舞丰收岁	猴吟锦绣春
高崖伏虎啸	茅庐卧龙飞
虎啸风声远	龙腾海浪高
龙引千江水	虎越万重山
密林藏伏虎	萝峰染晴云
山月流古雪	风虎浴清泉
事事都如意	虎虎有生气
云中熊虎将	天上凤凰儿
红鸡啼夜晓	黄犬吠年丰
猴引康庄道	鸡迎锦绣春
鸡鸣天放晓	政改地回春
鸡声窗前月	人笑福里春
鸡声天下曙	春意海南潮
金鸡日独立	紫燕春双飞
知廉标五德	报午必三鸣
龙腾翻巨浪	虎啸动春雷
万众思改革	群龙志腾飞
燕语新华喜	龙腾大地春
白鹅游暖岸	金马啸长风
百花开锦绣	万马起云烟
草枯鹰眼疾	霜尽马蹄轻
乘风腾骏马	兴国舞神龙
春拂芬芳地	马奔锦绣程
春来山水秀	马跃路途宽
春色绿千里	马蹄香万家
春新门载福	志远马扬蹄
丰年飞瑞雪	骏马跃长征
风度竹流韵	马驰春作声
共莺传捷报	赤兔踏春光
海阔凭鱼跃	路遥任马驰
花开天下福	马跃人间春
花香招鸟语	马跃起龙图
花绽春光谱	马驰中国风
金蟒穿云去	紫骝踏雪来
骏马生双翼	鸿图壮九州
凯歌辞旧岁	骏马迎新春
凯歌送旧岁	骏马迎新春
鲲鹏飞玉宇	骐骥跃神州
腊鼓催青骏	春风策紫骝
立马昆仑小	腾龙世纪新
立马千山矮	迎春万木荣
柳绿春江月	旗红骏马图
柳营晨试马	虎帐夜谈兵
马踏春锦绣	莺歌世风流
马腾风雪舞	春到杏花红
马腾改革路	国展富强图
马啸关山月	莺歌杨柳春
马跃康庄道	人迎幸福春
马跃阳关道	春回杨柳枝
群星瞻北斗	万马啸东风
人饮春节酒	马渡风月关
三春播喜气	万马荡雄风
三春开盛纪	万马闯雄关
蛇舞长城雪	马嘶北国风
神鞭催骏马	祖国壮金瓯
霜蹄千里骏	风翮九霄鹏
蹄花沾晓露	柳浪饰春风
天高鹏展翼	路远马扬蹄
万马奔腾日	九州幸福春
万马奔腾日	千门幸福春
万马争飞跃	百花展笑颜
闻鸡思奋发	跃马抖精神
闻鸡先起舞	跃马共迎春
小龙舞九州	大骥驰千里
雪中飞赤兔	月下赶黄彪
燕莺新气象	龙马壮精神
扬鞭催骏马	把酒会春风
一堂开淑景	万马会新春
迎春燕语巧	踏雪马蹄香
云霞出海曙	骏马跃关山
壮士喜骏马	红花爱英雄
百年推甲子	福地在春申
碧野青蛙叫	黄山松鼠鸣
丙辉觇瑞应	子庶庆丰登
丙辉腾瑞气	子庶乐丰年
苍松随岁古	子鼠与年新
春潮传喜讯	鼠岁报佳音
春风拂绿柳	灵鼠跳松青
春燕鸣暖树	金鼠跳青松
黄山松鼠跳	绿野早春归
黄山松鼠跳	子夜阳春来
黄莺鸣翠柳	金鼠恋苍松
鹊语红梅放	鼠年喜气浓
人欢为体健	鼠硕因年丰
豕去呈丰稔	鼠来报吉祥
豕去春无限	鼠来岁有余
鼠来豕去远	春到景更新
鼠为生肖首	春乃岁时先
鼠颖题春贴	鹊舌报福音
鼠至调新律	鸡鸣早报春
欣有鼠须笔	喜题燕尾书
新妆鼠嫁女	美景艳迎春
子年春到户	鼠岁喜临门
子时春意闹	鼠岁笑声甜
子时岁交替	鼠节春更新
子为地支首	鼠乃生肖先
子夜松涛劲	鼠年鹊语香
子夜岁交替	鼠年春更新
子夜钟声响	鼠年爆竹喧
蟾宫降玉兔	庭院绽红梅
丁年歌盛世	卯兔耀中华
耕田能获宝	养兔不守株
红梅香小院	玉兔下人间
红梅迎春笑	玉兔出月欢
红梅迎岁笑	玉兔伴娥欢
红梅迎雪放	玉兔踏春来
虎去威犹在	兔来运更昌
虎去雄风在	兔来喜气浓
虎声传捷报	兔影抖春晖
虎威惊盛世	兔翰绘新春
虎啸青山秀	兔奔碧野宽
虎跃前程去	兔携好运来
金鸡迎曙色	玉兔揽春光
金鸡争唱晓	玉兔喜迎春
卯门生喜气	兔岁报新春
卯门生紫气	兔岁报新春
兔归皓月亮	花绽春光妍
兔归月影笑	花绽春光妍
兔毫推赵地	麟管锡张华
兔岁添福气	龙人奋雄程
新春迎玉兔	华夏壮金瓯
寅年春锦绣	卯序业辉煌
玉兔蟾宫笑	红梅五岭香
玉兔迎春到	红梅祝福来
玉兔迎春至	黄莺报喜来
春草连天绿	羊群动地欢
春风追丽日	羊角步青云
春来羊起舞	雪化马归山
春新羊得草	世盛马加鞭
对韵俨龙马	联书大吉羊
红梅赠马岁	彩烛耀羊年
花香丰稔岁	燕舞吉祥图
金马辞旧岁	银羊贺新春
骏马奔千里	吉羊进万家
骏马春常在	吉羊福又添
骏马归山野	灵羊爱草原
腊鼓催神骏	春风送吉羊
马辟长安道	羊开大吉春
马驰金世界	羊唤玉乾坤
马带祥云去	羊铺锦绣来
马带祥云去	羊挟惠风来
马革酬壮志	羊碑纪丰功
马留英雄气	羊会世纪风
马年腾大步	羊岁展宏图
马去雄风在	羊来福气生
马首开新纪	羊肠拓锦途
马嘶飞雪里	羊舞画图中
马蹄留胜迹	羊角搏青云
马蹄留胜迹	羊毫谱新歌
马蹄腾瑞雪	羊角触红梅
马拓康庄道	羊挟惠风来
马拓康庄道	羊铺锦绣云
马有知途德	羊存跪乳恩
马跃庆丰年	羊鸣歌盛世
马载祥云去	羊携惠雨来
鸣莺传燕信	策马赴羊年
三羊开景泰	双燕舞春风
三羊开泰日	万事亨通年
三羊生瑞气	百鸟唤春光
笙歌辞旧岁	羊酒庆新春
万家腾笑语	四海庆阳春
未时骄阳艳	羊岁淑景新
五羊开玉局	万马闯雄关
五羊争献瑞	万马喜留春
羊毫书特色	燕翼绣春光
羊毫抒壮志	燕梭织春光
爆竹传吉语	腊梅报新春
亥时看入户	猪岁喜盈门
猪为六畜首	农乃百业基
爆竹欣祝福	银蛇喜迎春
龙腾丰稔岁	蛇舞吉庆年
晴点龙飞去	珠还蛇舞来
子岁先登富路	丑年再上新阶
犬吠佞人丧胆	鸡鸣玉宇生辉
舜犬重临华夏	犬年大展雄姿
春到红鬃马上	喜临绿柳门前
春到江南塞北	马腾正气清风
大地生香吐艳	神州跃马争春
飞雪片片凝瑞	马蹄声声报春
骏马秋风蓟北	杏花春雨江南
留下小龙胜景	迎来骏马新春
日丽风和景艳	人欢马叫春新
尚存金蛇灵气	重振龙马精神
天马横空出世	腊梅傲雪迎春
雪片纷纷凝瑞	马蹄得得报春
雪瑞年丰福满	人欢马叫春浓
升平岁辞戊辰	盛世春迎已巳
春自寒梅报起	年从玉兔迎来
春自卯时报起	福由兔口衔来
虎去犹存猛劲	兔来更显奇才
虎去犹留猛劲	兔来更显捷才
虎啸凯歌一曲	兔奔喜报九州
骏马四蹄击鼓	羚羊双角开春
立志当怀虎胆	求知莫畏羊肠
马去抬头见喜	羊来举步生风
马岁家家如意	羊年事事吉祥
马啸英雄浩气	羊鸣世纪春光
乌金黄土故地	白羊绿野新郊
喜鹊登枝祝福	灵羊及地呈祥
龙腾千年华夏	蛇舞世纪新春
白头能做识途马	俯首甘为孺子牛
爆竹喧天传喜庆	黄牛犁地播丰收
碧树红楼相掩映	黄牛骏马共迎春
碧桃无意随春水	黄犊有情鼓绿涛
碧野黄牛春日丽	红灯绿酒丽人年
布谷鸟鸣忙布谷	牵牛花绽喜牵牛
布谷声中闲人少	牧歌曲里颂春多
产奶无私甘奉献	充饥有草乐耕耘
诚心乐作人间事	俯首甘为孺子牛
川原蝶舞翩翩好	田野牛耕户户忙
春到人间新燕舞	喜盈门第铁牛忙
春归大地黄牛跃	神轾人间紫燕飞
春临门户白雪化	福降人间黄牛忙
辞旧迎新除硕鼠	富民强国效勤牛
辞鼠修仓迎稻熟	催牛耙地促年丰
翠柳迎春千里绿	黄牛耕地万山金
当年禹甸多铜马	今日春郊遍铁牛
丁年鼠匿辉煌业	丑岁牛奔旖旎春
耕者有牛皆种地	神州无处不欢歌
横心誓扫官仓鼠	俯首甘为孺子牛
红梅傲雪千门福	碧野放牛五谷丰
户户厌恶大硕鼠	家家喜爱老黄牛
花开江左白雪尽	春到人间黄牛忙
花木逢春枝叶茂	牛羊得草体膘肥
黄牛吃草生新奶	紫燕衔泥筑小巢
黄牛舔犊芳草地	紫燕营巢杏花天
黄土田间牛作画	紫微春苑燕吟诗
茧花绽放漫山绿	牛背飘来一曲歌
金光大道人催马	黄土高坡口吆牛
金牛开出丰收景	喜鹊衔来幸福春
君子闻声心不忍	庖丁善解目无全
可染画牛牛得草	悲鸿放马马扬鞭
腊梅花放雪将尽	春水温升牛甚忙
老牛力尽丹心在	志士年衰赤胆悬
良策善政多俊杰	乳牛老骥竞风流
绿柳摇风燕织锦	红桃沐雨牛耕春
牧草丛中春色美	放牛曲里笑声甜
牧童牛背春香路	游子马蹄梦醉乡
年丰人寿家家乐	春到花开处处耕
牛奔马跃行千里	凤舞龙飞上九霄
牛鞭当笔填新句	鸟语作歌报福音
牛耕碧野千畦秀	人值芳龄百事亨
牛耕沃野千畦绿	鹊闹红梅万朵红
牛耕沃野千山笑	雪映红梅小院香
牛郎不厌天河阔	织女但求凡世欢
牛郎弄笛迎春曲	天女散花祝福图
牛年喜奏丰年乐	人世笑迎盛世春
牛主乾坤春浩荡	人逢喜庆气昂扬
人勤一世千川绿	牛奋四蹄万顷黄
人寿年丰百姓乐	地肥水美众牛欢
人寿年丰农家乐	地肥水美春牛歌
人物风流心向党	黄牛勤奋力耕田
三春淑景景无丑	四化励人人效牛
神州无处不放彩	农户有牛喜迎春
鼠报平安归玉宇	牛随吉瑞下天庭
鼠年不做官仓鼠	牛岁甘为孺子牛
鼠年谱就惊天曲	牛岁迎来动地诗
鼠去牛来辞旧岁	龙飞凤舞庆新春
鼠去牛来闻虎啸	民殷国富盼龙飞
鼠去牛来欣大治	龙腾虎跃奋新程
数声柳笛飘牛背	无限春光亮马蹄
数声牧笛传新曲	四野耕犁试早春
蹄奋不须鞭震耳	牛勤何用用当头
铁牛喘月平畴绿	赤帜啸风满地红
铁牛拖出满山宝	茧手挖来遍地金
挺身勇灭官仓鼠	俯首甘为孺子牛
土生白玉牛羊壮	地产黄金鸡犬欢
为民当效黄牛力	报国壮怀赤子心
未许田文轻策马	愿闻老子再骑牛
五岭莺歌又燕舞	九州马叫并牛欢
写完福字描春字	迎到金牛买铁牛
新春乐咏黄牛颂	小院频传喜鹊歌
新春人唱黄牛赞	丰岁诗吟白雪歌
新春喜作黄牛颂	旭日高悬致富门
新村喜盼铁牛到	农家笑望春燕飞
新岁牧歌需纵酒	黄牛奋进不着鞭
一曲牧歌传牛背	无边柳色绿村头
勇当改革排头兵	甘作人民孺子牛
有福人家牛报喜	无边春色燕衔来
有庆年头牛得草	无垠大道马扬蹄
玉鼠回宫传捷报	金牛奋地涌春潮
玉碗生光辉琥珀	金牛焕彩耀星辰
猪肥牛壮家家乐	燕舞莺歌处处春
猪肥牛壮家增福	食足衣丰民自安
子去丑来腾锦绣	鼠归牛到竞辉煌
辞旧灵鸡歌日丽	迎新瑞犬报年丰
当于鸡鸣常起舞	莫为狗苟总偷安
狗护一门喜无恙	人勤四季庆有余
国富民强缘改革	鸡鸣犬吠报升平
鸡年利事家家乐	犬岁发财户户欢
鸡去瑶池传喜讯	犬来大地报春意
鸡声笛韵祥云灿	犬迹梅花瑞雪飞
鸡岁已添几多喜	犬年更上一层楼
鸡为岁归留竹叶	犬因春到献梅花
鸡追日月雄风舞	狗跃山河瑞气生
金鸡报捷梅花俏	义犬迎春柳色新
金鸡献瑞钦郅治	玉犬呈祥展宏猷
龙翔华夏迎新岁	气搏云天奋犬年
犬吠鸡鸣春灿灿	莺歌燕舞日瞳瞳
犬画红梅臻五福	鸡题翠竹报三多
犬效丰年家家富	鸡鸣盛世处处春
日新月异鸡报晓	岁吉年祥狗看门
瑞雪翩翩丰收景	犬蹄朵朵报春花
戍岁祝福万事顺	狗年兆丰五谷香
戌犬腾欢迎胜利	酉鸡起舞庆荣归
猴去鸡来胜利年	莺歌燕舞腾飞岁
猴喜满园桃李艳	岁迁遍地春光明
金猴献瑞财源广	紫燕迎春生意隆
金猴玉兔弄春色	紫燕黄莺弹妙音
紧握羊毫留青史	奋挥猴棒辟征程
满园春色关不住	两岸猿声报喜来
雪消门外千山绿	猴到人间万户春
羊羯回头添如意	猴王振臂保平安
银树呈祥花果硕	金猴献瑞国民殷
玉兔探月观新岁	金猴捧挑笑丰年
玉羊毫多添文采	金猴棒大鼓雄风
终迎胜利猴年赞	席再腾飞世人歌
紫燕展翅腾柳浪	金猴攀援上春山
百尺飞泉鸣震谷	一声长啸势惊天
丙部琳琅春馥郁	寅宾璀灿日光华
长白虎啸林中日	江南猿啼岭上风
赤县奔腾如虎跃	神州崛起似龙飞
丑旧寅新宏图展	牛归虎跃春意浓
丑去寅来千里锦	牛奔虎啸九州春
丑去寅来人益健	牛奔虎跃春愈新
春风浩荡神州绿	虎气升腾岳麓雄
春风着意随人愿	虎气生威壮国魂
春光春色源春意	虎将虎年扬虎威
春节乍闻春有喜	虎年乐见虎生风
春雷巨响山河动	月夜旋风草木飞
春晓寅回人起舞	岁祯虎啸物昭苏
电闪金光夸五色	雷鸣巨吼动千山
憨厚忠诚牛品德	高昂奋勇虎精神
虎步奔腾开胜景	春风浩荡展鸿图
虎踞龙盘今胜昔	花得鸟语旧更新
虎踞龙盘今胜昔	莺歌燕舞呈吉祥
虎年赢得春风意	喜讯唤来燕子情
虎气顿生年属虎	春风常驻户迎春
虎气频催翻旧景	春风浩荡著新篇
虎添双翼前程远	国展宏图事业新
虎啸大山山献宝	龙腾祖国国扬威
虎啸密林凤万壑	鹤眠苍松月千岩
虎啸青山千里锦	风拂绿柳万家春
虎啸一声山海动	龙腾三界吉祥来
虎跃龙腾生紫气	风调雨顺兆丰年
虎跃龙腾兴骏业	莺歌燕舞羡鹏程
虎跃神州千业旺	春临盛世万民欢
花事才逢花好日	虎年更有虎威风
黄牛虽去精神在	猛虎初来气象新
江山秀丽春增色	事业辉煌虎更威
江山一统腾龙日	岁月三春入虎年
皆称飞虎一身胆	不负英雄千古名
金牛昂首高歌去	玉虎迎春敛福来
金牛辞岁寒风尽	白虎迎春喜气来
金牛辞岁千仓满	玉虎迎春百业兴
金牛奋蹄奔大道	乳虎添翼舞新春
金牛奋蹄开锦绣	乳虎添翼会风云
金牛送旧千家乐	玉虎迎新万户欢
龙腾虎跃人间景	鸟语花香天地春
绿野春深禾涌碧	神州虎啸青山来
门庭虎踞平安岁	柳浪莺歌锦绣春
门浴春风梅吐艳	户生虎气鸟争鸣
年逢寅虎群情奋	岁别丑牛大地春
牛肥马壮丰收岁	虎跃龙腾大有年
牛肥马壮家家富	虎跃龙腾处处春
牛奋千程荣盛世	虎驮五福贺新春
牛奋四蹄开锦绣	虎添双翼会风云
牛耕绿野千仓满	虎啸青山万木荣
牛耕沃野扬长去	虎啸群山大步来
千载难逢新世纪	万民谱写虎春秋
乾元启运三阳泰	斗丙回寅万户春
人逢盛世精神壮	虎跃奇峰气势雄
人间喜庆康平世	虎岁承欢幸福春
人民气魄如龙虎	祖国江山似画图
人入虎年鼓虎劲	门添春色发春辉
人添志气虎添翼	雪舞丰年燕舞春
人效黄牛心自贵	岁朝寅虎劲更高
山明水秀风光丽	虎跃龙腾日月新
生气联吟欣虎虎	留春伴读奋年年
四海龙腾抒壮志	千山虎啸振雄风
四海三江春气息	千家万户虎精神
四海笙歌迎虎岁	九州英杰跃鹏程
唯大英雄能伏虎	是真俊杰敢擒龙
啸一声惊天动地	睁双眼照耀乾坤
新年捷报虎添翼	大路朝阳马奋蹄
兴伟业仍须牛劲	展宏图更壮虎威
一代英豪生虎气	三春杨柳动莺歌
英雄气概如龙虎	祖国江山似画图
英雄时代英雄业	龙虎精神龙虎年
莺歌燕舞新春日	虎跃龙腾大治年
迎春节莺歌遍地	兴中华虎劲冲天
云喷笔花腾虎豹	雨翻墨浪走蛟龙
宅后青山金虎踞	门前绿水玉龙盘
致富脱贫添虎翼	开山治水展鹏程
把酒当歌歌盛世	闻鸡起舞舞新春
保驾护航奔富路	昂头振翼唱东风
癸戴草头朝赤日	酉添春水上朱颜
国家安定人民乐	党政清廉事业兴
红日升空辉大道	金鸡报晓促长征
猴奋已教千户乐	鸡鸣又报万家春
鸡报小康随日出	年迎大有伴春来
鸡描竹叶三中颂	犬绘梅花五福临
鸡鸣喜报丰收果	犬吠欣迎富贵宾
鸡鸣晓日江山丽	犬吠神州岁月新
鸡鸣紫陌迎新曙	马踏青云奔小康
鸡声一唱东方白	猴棒三挥玉宇清
金猴留恋丰收年	彩凤欢啼盛世春
金鸡报晓歌大治	丹凤朝阳赞中兴
金鸡高唱迎春曲	铁牛欢催改革潮
金鸡唤出扶桑日	锦犬迎来大地春
金鸡喜唱催春早	绿柳轻摇舞絮妍
金鸡一唱传佳讯	玉犬三呼报福音
两岸金鸡歌一统	九州赤子报三春
鸟报晴和花报喜	鸡生元宝地生财
犬能守夜迎新岁	鸡可司里送旧年
四海升平歌舜日	九州盛世乐尧天
万户桃符新气象	群山霞彩富神州
万象喜回春守信	一元欣复始司晨
闻鸡起舞迎元旦	击壤而歌颂小康
喜爆千声歌盛世	金鸡三遍报新春
喜鹊登枝迎新岁	金鸡起舞报福音
雄鸡唱罢九州乐	金犬吠来四海安
雄鸡喔喔颂尧天	腊狗汪汪歌舜日
雄鸡喜报春光好	健笔勤书正气多
雄鸡喜唱升平日	志士欢歌改革年
雄鸡一唱天下白	锦犬再雕宇宙春
跃马扬鞭芳草地	闻鸡起舞杏花天
澳归犹凭龙剑气	邦兴勿忘虎门烟
八面威风增国力	九州春色启龙年
百尺高梧栖彩凤	万川汇海起蛟龙
报春乐曲神龙吟	强国宏图众手描
北海云生龙对舞	丹山日上凤双飞
笔架山高才气现	砚池水满墨龙飞
笔走神龙大手笔	春归盛世好青春
笔走神龙凭大手	诗流雅韵有高人
碧海惊涛龙献瑞	苍梧茂叶凤呈祥
才闻兔岁凯旋曲	又唱龙年祝福歌
彩凤来仪迎大治	金龙起舞庆新春
苍龙半挂秦川雨	石马长嘶汉苑风
苍龙日暮还行雨	老树春深更著花
苍梧拔地栖金凤	碧海连天潜玉龙
辰居其所众星拱	龙腾于天万国钦
辰年迪吉千重瑞	龙岁呈祥四季宁
辰日一轮驰浩宇	龙年百业壮中华
赤兔追风千里志	金龙拱日万家春
出海神龙开世纪	挥毫妙笔颂春秋
春到人间争虎跃	喜传域外庆龙飞
春光明媚江山上	龙虎腾飞事业中
春节迎来春气象	龙年抖擞龙精神
春日春风春浩荡	龙年龙岁龙腾飞
春雨多情绿大地	金龙展志壮神州
大业功成惊世界	巨龙飞跃盛中华
大丈夫无须待兔	有志者必定腾龙
大治凤鸣尤乐耳	小康龙舞更开心
丹凤朝阳歌盛世	苍龙布雨润神州
丹霞瑰丽神龙舞	大路康庄骏马驰
动地惊天龙气象	锦山绣水凤文章
风发龙门春浪暖	日临雁塔晓云开
风来松度龙吟曲	雨过庭余鸟迹书
改革迎来金虎啸	开放喜看玉龙腾
刚唱兔岁歌一曲	又饮龙年酒三杯
庚呈瑞彩迎春节	辰绽联花拓盛元
庚序开元民奋发	辰年启泰国腾骧
国策英明增国力	龙年飞跃展龙图
国富民殷龙献瑞	年丰物阜凤还巢
国运国兴凭国策	龙飞龙跃靠龙人
海阔何愁龙跃水	山高岂妒凤朝阳
虎啸无弦惊海宇	龙吟有意动河山
虎跃龙腾欢盛世	莺歌燕舞贺新春
户吉家祥歌且舞	龙盘虎踞慨而慷
花柳春风催燕舞	英雄祖国盼龙飞
华堂戏燕春风暖	盛世腾龙国色娇
华夏大地春常在	文明古国尽朝晖
华夏龙腾金鼓壮	新春马跃玉珂鸣
华夏龙腾金鼙壮	神州兔跃玉仓盈
华夏扬威惊世界	巨龙昂首恃风雷
黄龙行雨腾沧海	紫凤驾云上碧霄
挥毫凤舞千山秀	泼墨龙飞万水腾
绘龙图铭心济世	存虎胆立志兴邦
江河湖海凭龙跃	山岳峰峦任虎行
江山故国堪留鹤	华夏高天可腾龙
江山故国堪留鹤	华夏昊天可跃龙
江山秀丽神龙舞	道路逶迤骏马驰
江山依旧龙盘踞	世纪更新国富强
蛟龙出海迎红日	紫燕归门报早春
蛟龙腾海风雷激	莺燕闹春杨柳青
金龙报春春风暖	铁手造福福气浓
金龙出海迎新岁	彩凤朝阳贺小康
金龙闹海春潮涌	喜鹊登枝福韵高
金龙献瑞苏千里	绿柳迎春乐万家
锦绣山川春色绣	奔腾江海巨龙腾
九九祥云舒玉兔	千千情结系金龙
九天揽月中华志	四海腾龙民族魂
九州丽日迎新纪	四海龙吟乐大年
巨龙腾跃中华志	猛虎催啸民族魂
刻翠裁红新格调	屠龙刺虎好文章
快抓良机辞兔岁	欣承国运展龙图
况向长征驰赤兔	敢为四化缚苍龙
浪翻南海潜龙至	风振紫霄翔凤归
莲花锦地歌妈祖	荆树光天颂九龙
炼塔凌空荣广宇	油龙出海壮神州
两袖清风龙虎惧	一身正气鬼神惊
龙步青云酬壮志	鹏飞碧宇览神州
龙从百丈潭中起	春自千重锦上来
龙开盛纪新春丽	国展宏图大业娇
龙门丽景催鱼跃	祖国宏图任我描
龙门一跳迎新岁	燕子双飞报好音
龙省龙年龙起舞	虎林虎地虎飞腾
龙岁初临勤努力	辰光正亮著先鞭
龙岁迎来新世纪	莺歌唱出好春光
龙腾广宇添新秀	兔丽长河展壮图
龙腾虎跃春光好	鸟语花香世纪新
龙腾虎跃风云壮	物阜年丰国运昌
龙腾虎跃光明地	海晏河清锦绣天
龙腾虎跃闹春意	人寿年丰谢党恩
龙腾虎跃新世纪	年富力强好时光
龙腾虎跃兴大治	燕舞莺歌庆升平
龙腾华夏金鼙壮	春暖虞唐草木荣
龙腾华夏钟灵地	德启门庭毓秀人
龙腾盛世千家喜	春满神州万物荣
龙腾涛海易天历	虎变风云驾海虬
龙腾伟业超千古	鹏舞雄姿搏九霄
鼠去牛来闻虎啸	民殷国富盼龙飞
鼠去牛来欣大治	龙腾虎跃奋新程
数声柳笛飘牛背	无限春光亮马蹄
数声牧笛传新曲	四野耕犁试早春
蹄奋不须鞭震耳	牛勤何用用当头
铁牛喘月平畴绿	赤帜啸风满地红
铁牛拖出满山宝	茧手挖来遍地金
挺身勇灭官仓鼠	俯首甘为孺子牛
土生白玉牛羊壮	地产黄金鸡犬欢
为民当效黄牛力	报国壮怀赤子心
未许田文轻策马	愿闻老子再骑牛
五岭莺歌又燕舞	九州马叫并牛欢
写完福字描春字	迎到金牛买铁牛
新春乐咏黄牛颂	小院频传喜鹊歌
新春人唱黄牛赞	丰岁诗吟白雪歌
新春喜作黄牛颂	旭日高悬致富门
新村喜盼铁牛到	农家笑望春燕飞
新岁牧歌需纵酒	黄牛奋进不着鞭
一曲牧歌传牛背	无边柳色绿村头
勇当改革排头兵	甘作人民孺子牛
有福人家牛报喜	无边春色燕衔来
有庆年头牛得草	无垠大道马扬蹄
玉鼠回宫传捷报	金牛奋地涌春潮
玉碗生光辉琥珀	金牛焕彩耀星辰
猪肥牛壮家家乐	燕舞莺歌处处春
猪肥牛壮家增福	食足衣丰民自安
子去丑来腾锦绣	鼠归牛到竞辉煌
龙腾喜浪迎新纪	兔乐丰仓送旧年
龙腾霄汉开新宇	鹊立梅梢报福音
龙腾霄汉开新运	鹊立枝头报好音
龙腾新纪百年好	马跃长征万里遥
龙腾云海国昌盛	春满人间民泰安
龙兴阳动乾坤晓	政协人和天地春
龙萦华表冲霄汉	兔降葡旗别澳门
龙游沧海江湖小	狮醒神州世界惊
龙种自与常人殊	鹏鸟岂堪同日语
龙族喜迎千禧岁	华人欢度万荣春
梅花香遍神州地	龙步震开盛纪春
梅柳三春飞雏燕	炎黄一脉是神龙
梅为春意赋新意	雪向龙年报丰年
梅为小院添春色	鹊向龙年报好音
门对龙山门进宝	户栽花树户生辉
民情雀跃符民意	国步龙腾壮国威
民族振兴增国力	中华崛起赖龙人
明山卧虎吉祥地	丽水腾龙锦绣程
鸟鸣春日惊山水	鱼跃龙门动地天
七彩云霞铺锦绣	一池翰墨舞龙蛇
七五征程如奔兔	三中伟业胜腾龙
千家福气金龙降	万里春光紫燕衔
千里云霞辉大地	万般气象壮龙年
千秋事业神龙舞	一代风流骏马驰
千禧龙年歌盛世	万家灯火庆新春
千寻凤阁攀云上	五色龙江抱江流
青云浩气腾龙步	捷报宏图振国威
人心思治江山固	国步腾龙世纪新
人心向党人承福	国步腾龙国更强
日丽三江金凤舞	虹飞五岳巨龙腾
如意春风催虎啸	吉祥云彩壮龙腾
瑞霭满堂年喜庆	神龙闹海世清明
三中花雨播龙种	十亿神州起凤毛
诗画满园铺锦绣	风雷动地走龙蛇
狮醒九州驱虎豹	龙腾四海息风波
世纪春光辉大地	江山国色舞神龙
世纪风云龙际会	春风杨柳燕剪裁
世纪更新龙出海	春光焕彩燕衔泥
世纪图腾龙翘首	中华崛起国扬眉
书因鸟迹方成篆	文是龙心不待雕
四化征途加马力	三阳开泰颂龙年
送玉兔吴刚捧酒	驾金龙敖广献珠
岁降金龙蒙化雨	年逢惠政沐春风
天地神龙开盛纪	人间紫燕舞新春
兔辞胜岁传佳话	龙奋新程建大功
兔毫描绘江山画	龙目乐观世纪春
兔年捷报惊世界	龙岁雄风震乾坤
兔随冬去留春意	龙伴春来壮画图
万里春风苏绿野	八方喜雨起苍龙
万水千山凭虎跃	五湖四海任龙腾
万物呈祥荣盛世	九龙献瑞庆良辰
唯大英雄能伏虎	是真豪杰乃降龙
无边春色来天地	有志金龙越古今
昔年虎啸千山壮	今日龙腾四海春
喜报人间曾伏虎	新开世纪正腾龙
喜看龙年花千树	笑饮改革酒一杯
喜庆爆竹送玉兔	吉祥梅花迎金龙
喜兔岁九州丰稔	愿龙年百业昌荣
小康岁月多春意	大泽蛰龙起泰山
欣看大地千重秀	笑望巨龙四海飞
欣闻禹域鸣雏凤	喜看神州起卧龙
新岁迎来新世纪	大龙谱写大文章
幸福家庭龙虎卧	文明宅第子孙贤
旭日东升丹凤舞	中华崛起巨龙飞
学海潮头龙影动	书山路上凤声高
燕舞莺歌相比美	龙腾虎跃竞争先
一代龙人开盛纪	九州大地起宏图
一联壮我楹间色	万里腾龙海内春
一片惊涛龙出海	八方锦绣燕衔春
一元复始龙增岁	万物生辉燕报春
已去庚来腾瑞气	卯归辰至发祥光
英雄儿女鲲鹏志	锦绣江山龙虎姿
英雄自有凌云志	时代呼唤潜海龙
莺歌燕舞春光美	虎跃龙腾国事兴
迎龙年唯求国利	喜新政只为宜民
鱼跃龙门千业振	民奔富路万家欢
鱼跃鸢飞惊海宇	龙吟虎啸咤风云
玉兔呈欢辞旧岁	神龙跃起展鸿猷
玉兔呈祥留硕绩	金龙献瑞创辉煌
玉兔辞年传吉利	金龙贺岁保平安
玉兔回宫留福泽	金龙下界沐祯祥
玉兔回宫攀月桂	金龙浴日上云霄
玉兔升腾蟾阙里	金龙飞舞彩云间
云近紫台龙虎气	春回青苑凤麟游
云灵化鹤人增寿	海啸腾龙国有威
云龙上下驰东野	雪鹤飞扬入北山
指点江山扬国粹	笔挥风雨走龙蛇
中华儿女鲲鹏志	祖国江山龙虎姿
中华民族龙传世	百鸟成群凤向阳
中华跃日神龙舞	大地迎春紫燕飞
中华振兴巨龙舞	大地焕然万象新
装点江山凭妙手	更新世纪在龙年
紫气缭桐招凤落	春雷带雨壮龙腾
紫微祥气腾龙态	伟业宏图壮国威
紫燕飞来寻玉兔	黄鹂唱起戏金龙
紫燕庭前传吉语	金龙户外报佳音
昂首扬鬃腾浩气	奋蹄踏雪展春风
八骏风驰千里近	一年花发十分红
白马壮心奔大道	青春浩气献中华
百花齐放春光好	万马奔腾国步雄
百花齐放春光好	万马奔腾气象新
爆竹声声催快马	梅花朵朵笑春风
奔彼岸千帆竞渡	越坦途万马扬鞭
奔腾骏马驰大道	浩荡春风遍神州
伯乐明眸识好马	良才妙手展宏图
伯乐选贤识骏骥	英雄酬志效鲲鹏
策马前驱奔四化	闻鸡起舞超群英
车水马龙农家乐	花香鸟语大地春
车水马龙一路景	花香鸟语万家春
春返神州舒画卷	马腾盛世入诗篇
春风碧水双鸥静	旭日青山万马嘶
春风得意人得志	骏马扬蹄国扬威
春风化雨芭蕉翠	骏马登程杨柳青
春风骏马开新纪	大业宏图壮国威
春风送暖花千树	骏马扬蹄路万程
春风万里辞蛇岁	笑语千家入马年
春风笑逐福音至	天马喜随捷报飞
春光原自梅梢发	诗句竞于马背吟
春归禹甸风光美	马纵山河气势雄
春花吐艳香千里	快马加鞭跃九州
春江花月宜人景	龙马海风强国图
春日寻芳骑骏马	国家思治用贤才
春天点点芭蕉雨	马步声声杨柳风
春阳送暖芳菲地	骏马奔驰锦绣程
春寓枝头歌唤马	马驰大道喜迎春
春寓枝头迎佳节	福在心里接马年
辞年喜饮三蛇酒	贺岁争描八骏图
大道扬鞭驰骏马	高天阔地展雄才
大路长征驰骏马	中华伟业展雄才
大鹏俯视万春寨	天马驰骋五里街
大鹏欢喜天空阔	骏马何愁道路长
大鹏展翅青云路	骏马奔驰浩荡春
得意春风催骏马	及时惠雨润鲜花
东方古国红旗舞	大路长征骏马驰
冬去蛇留诗意里	春来马入画图中
冬去蛇留诗意美	春来马跃画图新
飞驰骏马鞭高举	欢庆新年酒满斟
风尘一路马蹄碎	爆竹千家春意浓
风光秀丽随春展	道路逶迤任马驰
伏枥犹存千里志	添翼更上九重天
福到门庭梅吐艳	马驰道路柳生烟
改革新潮催骏马	振兴大业起宏图
高天雪舞银蛇去	大地春归骏马来
庚晨日暖春来早	午院花香蝶舞忙
古柳荫中来走马	好花深处有鸣禽
豪情振笔歌新岁	骏马加鞭奔坦途
好借春风酬壮志	快催骏马跃前程
好凭妙手书鹏赋	当显雄才唱大风
好雨知时群卉盛	春风得意四蹄轻
红旗辉映神州地	骏马喜迎大治年
红旗招展九州画	骏马奔腾万里春
红旗指引强邦路	骏马驰骋富国途
红霞瑰丽铺云路	骏马奔腾荡柳烟
宏图锦绣众人绘	大道逶迤万马驰
鸿雁翔云迎旭日	青骝夺路起桃烟
花柳新春莺燕舞	风云盛世骏骐驰
花木向阳春不老	骅骝开道景无边
化雨携来龙露贵	踏花归去马蹄香
江涛气势风雷动	龙马精神世纪兴
捷报随雪飞梅上	蹄花染香到春头
金戈铁马奔大道	碧血丹心献中华
金蛇狂舞九州景	骏马欢腾四海春
金蛇起舞颂功去	骏马奔腾报捷来
金蛇喜舞九州富	骏马欢腾四海春
九天日暖张鹏翼	四野春新逐马蹄
举红旗旗开得胜	乘骏马马到成功
骏马奔腾春色丽	艳阳照耀岁华新
骏马奔腾千里路	新春更上一层楼
骏马奋蹄千里路	大鹏舒翼九重天
快马加鞭争朝夕	壮志凌云写春秋
蓝图全靠能人绘	骏马还凭伯乐挑
老骥常存千里志	夕阳惯照万重山
勒马开怀颂改革	迎春祝酒庆丰年
灵蛇匿迹飞青霭	天马行空驾白云
龙伴腊归留胜迹	骥随春到展宏图
龙马精神驰大道	鲲鹏志向搏高天
龙马精神壮四海	风云气象会三春
绿水青山迎宝马	红梅白雪送灵蛇
诚心乐作人间事	俯首甘为孺子牛
川原蝶舞翩翩好	田野牛耕户户忙
春到人间新燕舞	喜盈门第铁牛忙
春归大地黄牛跃	神轾人间紫燕飞
春临门户白雪化	福降人间黄牛忙
辞旧迎新除硕鼠	富民强国效勤牛
辞鼠修仓迎稻熟	催牛耙地促年丰
翠柳迎春千里绿	黄牛耕地万山金
当年禹甸多铜马	今日春郊遍铁牛
丁年鼠匿辉煌业	丑岁牛奔旖旎春
耕者有牛皆种地	神州无处不欢歌
横心誓扫官仓鼠	俯首甘为孺子牛
红梅傲雪千门福	碧野放牛五谷丰
户户厌恶大硕鼠	家家喜爱老黄牛
花开江左白雪尽	春到人间黄牛忙
花木逢春枝叶茂	牛羊得草体膘肥
黄牛吃草生新奶	紫燕衔泥筑小巢
黄牛舔犊芳草地	紫燕营巢杏花天
黄土田间牛作画	紫微春苑燕吟诗
茧花绽放漫山绿	牛背飘来一曲歌
金光大道人催马	黄土高坡口吆牛
金牛开出丰收景	喜鹊衔来幸福春
君子闻声心不忍	庖丁善解目无全
可染画牛牛得草	悲鸿放马马扬鞭
腊梅花放雪将尽	春水温升牛甚忙
老牛力尽丹心在	志士年衰赤胆悬
良策善政多俊杰	乳牛老骥竞风流
绿柳摇风燕织锦	红桃沐雨牛耕春
牧草丛中春色美	放牛曲里笑声甜
牧童牛背春香路	游子马蹄梦醉乡
年丰人寿家家乐	春到花开处处耕
牛奔马跃行千里	凤舞龙飞上九霄
牛鞭当笔填新句	鸟语作歌报福音
牛耕碧野千畦秀	人值芳龄百事亨
牛耕沃野千畦绿	鹊闹红梅万朵红
牛耕沃野千山笑	雪映红梅小院香
牛郎不厌天河阔	织女但求凡世欢
牛郎弄笛迎春曲	天女散花祝福图
牛年喜奏丰年乐	人世笑迎盛世春
牛主乾坤春浩荡	人逢喜庆气昂扬
人勤一世千川绿	牛奋四蹄万顷黄
人寿年丰百姓乐	地肥水美众牛欢
人寿年丰农家乐	地肥水美春牛歌
人物风流心向党	黄牛勤奋力耕田
三春淑景景无丑	四化励人人效牛
神州无处不放彩	农户有牛喜迎春
鼠报平安归玉宇	牛随吉瑞下天庭
鼠年不做官仓鼠	牛岁甘为孺子牛
鼠年谱就惊天曲	牛岁迎来动地诗
鼠去牛来辞旧岁	龙飞凤舞庆新春
绿野苍茫驰骏马	蓝天浩翰搏雄鹰
马奔大道风生响	春到农家雪吐香
马不停蹄传捷报	人行阔步闯雄关
马步青云迎旭日	羊腾绿野展雄风
马驰大路春如锦	鹰击长空气若虹
马逢伯乐驰千里	鹏过高天展万程
马叫人欢奔旭日	风驰电掣奋征程
马蹄得意奔新路	鹊语遂心报好音
马蹄捷报映晓日	燕语茑歌迎新年
马蹄声碎开新路	春酒味浓贺大年
梅花欢喜漫天雪	骏马奔驰一路春
美景前程欣骥足	高天浩宇快鹏心
门畔春色迎年秀	马前征途映眼新
门前春色迎人笑	路上蹄花映眼新
秣马厉兵操胜券	强邦兴国献良谋
南岭梅香迎岁至	东效草浅试蹄轻
鹏举长空九万里	马驰盛纪二千年
齐策战马迎新岁	满斟美酒贺丰年
骑马挎枪迎曙色	携春带福送人间
旗展五星四海笑	马奔万里九州春
千畴竞秀丰收景	万马奔腾改革图
千帆竞渡千重浪	万马奔腾万里春
千里江山春气象	一年锦绣马风光
千树春花争早放	万骑骏马着先鞭
青春壮丽辉天地	骐骥奔腾向未来
庆佳节九州同乐	贺新春万马奔腾
庆盛世雄狮起舞	展宏图快马加鞭
秋风古道题诗瘦	落日平原似马豪
人得春风牛得草	国扬威力马扬蹄
人欢马叫丰收岁	狮舞龙腾改革潮
人欢马叫升平世	燕语莺歌锦绣春
人强马壮康乐日	囤满仓盈富裕年
瑞霭盈门春在户	红旗引路马扬蹄
三春芳讯传莺口	万里东风逐马蹄
色借梅花香借雪	壮观骏马美观春
山舞银蛇梅吐艳	原驰骏马草含春
蛇辞禹甸三春丽	马跃神州百业兴
神笔马良画彩骏	慧眸伯乐选名驹
神驹轻踏春前草	小燕喜穿柳上风
十分春色辉天地	万马蹄花入画图
十里早莺鸣暖树	一群骏马跃雄关
时代强音催快马	中华特色壮金瓯
世纪春风吹绿野	中华神马啸新程
水如碧玉山如黛	人奋雄心马奋蹄
腾飞骏马奔千里	改革春风暖万家
腾海蛟龙频击浪	识途老马自扬蹄
蹄花千里沾晨露	柳浪万重叠夕阳
天高碧宇随鹏举	路远轻风任马驰
天马行空迎盛纪	黄莺戏柳报新春
挺身愿作长征马	俯首甘为孺子牛
鼠去牛来闻虎啸	民殷国富盼龙飞
鼠去牛来欣大治	龙腾虎跃奋新程
数声柳笛飘牛背	无限春光亮马蹄
数声牧笛传新曲	四野耕犁试早春
蹄奋不须鞭震耳	牛勤何用用当头
铁牛喘月平畴绿	赤帜啸风满地红
铁牛拖出满山宝	茧手挖来遍地金
挺身勇灭官仓鼠	俯首甘为孺子牛
土生白玉牛羊壮	地产黄金鸡犬欢
为民当效黄牛力	报国壮怀赤子心
未许田文轻策马	愿闻老子再骑牛
五岭莺歌又燕舞	九州马叫并牛欢
写完福字描春字	迎到金牛买铁牛
新春乐咏黄牛颂	小院频传喜鹊歌
新春人唱黄牛赞	丰岁诗吟白雪歌
新春喜作黄牛颂	旭日高悬致富门
新村喜盼铁牛到	农家笑望春燕飞
新岁牧歌需纵酒	黄牛奋进不着鞭
一曲牧歌传牛背	无边柳色绿村头
勇当改革排头兵	甘作人民孺子牛
有福人家牛报喜	无边春色燕衔来
有庆年头牛得草	无垠大道马扬蹄
玉鼠回宫传捷报	金牛奋地涌春潮
玉碗生光辉琥珀	金牛焕彩耀星辰
猪肥牛壮家家乐	燕舞莺歌处处春
猪肥牛壮家增福	食足衣丰民自安
子去丑来腾锦绣	鼠归牛到竞辉煌
万里清风舒画卷	一鞭神骏奋前程
万里征途千里马	十年树木百年人
万缕彩霞迎旭日	千匹骏马带朝烟
万马奔腾五彩路	百花齐放四时春
万马千军创大业	五湖四海涌春潮
伟业千秋人奋志	征途万里马嘶风
魏武挥鞭吟老骥	悲鸿泼墨画神驹
文明社会春风意	龙马精神海鸥姿
文明盛世飞春色	锦绣前程亮马蹄
文章须纳风云气	翰墨应催骏马图
无边春色百花艳	有庆年头万马驰
无须添足蛇归洞	不待扬鞭马奋蹄
午岁争迎千里马	新春更上一层楼
向阳花木三春秀	得意马蹄一路风
小龙大殿鹏飞志	骏马方乘改革风
小龙游罢清平世	骏马腾欢大有年
新春贴留吉祥草	骏马图挂墨韵斋
新骏扬鞭奔大道	亲朋酌酒贺丰年
新岁更腾千里马	壮心高展九霄鹏
雄关似铁千骑越	捷报如云万里飘
雄狮竞舞中华志	骏马奔腾民族风
雄心驯服腾云马	壮志敢擒出海龙
扬鞭策马开新纪	立志兴邦展壮猷
一代英豪图伟业	九州骏马踏雄风
一路马蹄花引蝶	万家春色柳闻莺
一任马蹄敲战鼓	几番旷野卷高尘
一夜春风来小院	千匹骏马闯雄关
银蛇带去峥嵘岁	骏马迎来锦绣春
银蛇喜送峥嵘岁	骏马欣迎锦绣春
银蛇蛰伏藏瑰宝	骏马腾飞起宏图
英才竞献兴邦策	骏马齐奔强国途
英雄骏马奔千里	浩荡春风暖万家
英雄魄力惊天地	龙马精神贯古今
英雄气概凌天宇	骏马雄风荡柳烟
莺歌柳浪千家笑	马踏春风一路花
莺歌燕舞芳菲节	马叫人欢婀娜春
莺歌燕舞芳菲节	马叫人欢艳阳春
莺歌杨柳枝枝秀	马跃前程步步高
鹰击长空抒远志	马驰碧野卷雄风
迎春策马声威壮	破浪扬帆气势雄
映日红霞浮白马	宜人春色到农家
有志宝驹奔大道	无边春色驻神州
院内红梅输白雪	途中赤兔步青云
跃马乘风奔大道	腾龙出海振神州
跃马日行九万里	腾龙历展二千年
跃马扬鞭抒壮志	耕云播雨夺丰收
张灯结彩迎春节	跃马扬鞭步小康
政策归心人振奋	春风得意马腾飞
政策英明民放胆	神驹腾飞国扬威
壮志凌云振鹏翼	扬鞭催马奔征程
紫气东来春得意	青云直上马扬蹄
八法龙蛇寻奥妙	万方翰墨出精微
笔走龙蛇资雅韵	诗题福寿贺新春
辰龙回宫欣报捷	巳蛇出洞喜迎新
辰岁腾飞惊广宇	巳年奋搏震寰球
城乡改革龙蛇舞	梅柳争春世纪新
出常山而雄岁月	腾大泽以壮神州
春风送暖蛇年好	瑞气盈门鹊语香
春花吐艳蛇生瑞	芝草含嫣鹿启祥
春帖相延新换旧	龙蛇交替瑞呈祥
春意盎然蛇起舞	民情振奋燕翻飞
大业中兴新世纪	宏图再展小龙年
大泽龙伏藏远志	莽原蛇蜕蕴生机
大展宏图华夏伟	新开世纪小龙飞
大治山河铺锦绣	小龙日月更辉煌
当代精英抒壮志	蛇年禹甸起宏图
当代英雄驱虎豹	崭新世纪舞龙蛇
丰年盛景龙蛇舞	新岁春光彩蝶飞
丰稔龙年留喜气	小康蛇岁溢春潮
丰收喜讯龙刚报	长寿灵芝蛇又衔
丰岁龙腾盈喜气	新年蛇跃涌春潮
风调雨顺年丰稔	龙去蛇来岁吉祥
风光无限蛇开泰	事业有为国展姿
风华正茂青春美	蛇岁呈欢世纪新
冯妇无憾重伏虎	颠客逞能赘画蛇
庚辰胜岁堂堂去	辛巳芳春鼎鼎来
金龙含珠辞旧岁	银蛇吐宝贺新春
金山水漫双蛇舞	绿野春归百鸟鸣
金蛇狂舞春添彩	紫燕翻飞柳泛青
金蛇狂舞丰收岁	玉燕喜迎幸福春
金蛇狂舞迎春曲	丹凤朝阳纳吉图
金蛇狂舞迎新纪	瑞雪纷飞兆好年
金蛇妙舞随金马	玉律清音溢玉堂
金蛇披彩新春到	喜鹊登梅幸福来
金蛇起舞春雷动	玉盏飞觞腊酒香
九州崛起龙蛇舞	十亿腾飞骐骥欢
灵蛇出洞吐春意	喜鹊登梅报福音
灵蛇飞舞千山秀	神骏奔腾九野新
灵蛇起舞迎新纪	快马加鞭奔富途
灵蛇有意降春雨	绿叶无私缀牡丹
龙抖雄姿归大海	蛇含瑞气报年华
龙归碧海波涛舞	蛇到青山草木新
龙回海底欣迎岁	蛇出山穴喜报春
龙驾祥云门敛福	蛇衔瑞草户迎春
龙留瑞气常萦户	蛇报福音久驻门
龙年共庆辉煌日	蛇岁同奔锦绣程
龙年国展腾飞志	蛇岁民抒奋发情
龙去蛇来吟古韵	莺歌燕舞谱新章
龙蛇共舞三春景	鸾凤齐鸣四海祥
龙蛇竟舞春光艳	骐骥争驰淑景新
龙岁才舒千里目	蛇年更上一层楼
龙岁才舒千里目	巳年更上一层楼
龙岁已开新世纪	蛇年又展好春光
龙腾大地春阳丽	蛇舞神州胜纪新
龙腾广宇江山丽	蛇舞神州岁月新
龙腾华夏春光丽	蛇蛰神州福气浓
龙腾九域千年禧	蛇舞三春万象新
龙腾盛世千年瑞	蛇舞神州万代荣
龙腾四海家家乐	蛇舞九州处处新
龙腾宇际春烂漫	蛇步锦程业辉煌
龙戏宝珠辞旧岁	蛇衔瑞草贺新春
龙戏高天鱼戏水	蛇游大泽燕游春
龙兴大业开新纪	蛇舞阳春奏凯歌
龙昭日月雄风在	蛇壮山河锐意增
绿水欢歌歌盛纪	银蛇起舞舞新春
去年龙蛰千重景	今日蛇迎四海春
人怀壮志江山秀	蛇报新春世纪新
人民有福歌新政	祖国长春舞小龙
山高水远人增志	蛇接龙年地满春
山欢水笑普天乐	龙去蛇来遍地春
山蛇起舞云行雨	喜鹊争鸣雪点梅
山舞银蛇春烂漫	路驰骏马景妖娆
山舞银蛇迎巳岁	原驰蜡象送辰年
蛇年四季百花艳	燕影千家五谷丰
蛇年喜庆丰收景	燕语欢歌幸福家
蛇吐宝珠辞旧岁	燕衔柳叶贺新春
蛇吐宝珠辞旧岁	龙含瑞气贺新春
蛇献金珠龟献寿	鸟鸣玉宇鹿鸣春
蛇献灵芝长寿草	民欢富裕小康年
蛇行瑞气增春色	人展宏图壮国威
盛世龙腾留伟业	新年蛇舞起宏图
世纪更新人不老	灵芝献寿蛇迎春
世纪门前蛇起舞	梧桐树上凤呈祥
世纪神州添锦绣	蛇年伟业更辉煌
寿比青松福比海	蛇盘玉兔鹊盘梅
寿草惊蛇开眼绿	春花惹蝶向阳红
四海龙腾佳日去	千年蛇蛰早春来
四野蛇呈丰稔景	万民雀跃艳阳天
岁辞大泽春风劲	人舞小龙世纪新
岁辞龙尾春光好	山舞蛇姿景色新
岁去年来新换旧	龙潜蛇舞景成春
天地迎春弃旧貌	龙蛇接力展宏图
天蓝水碧青蛇降	柳绿桃红紫燕飞
天浴朝阳蓬勃气	蛇含芝草吉祥年
天增岁月开新纪	春满乾坤舞小龙
天征瑞象迎新岁	山舞银蛇庆早春
喜鹊高歌传捷报	金蛇狂舞庆丰年
小龙得志行风雨	彩蝶迎春戏牡丹
小龙起舞神州地	祖国腾飞大治年
辛盘喜钦丰收酒	巳岁欣荣富贵春
辛岁腾飞凭政策	巳年改革重科研
辛夜平安开景远	巳年大吉启新程
新春喜鹊登枝唱	吉地银蛇降福来
银花火树新春夜	丹凤金蛇大治年
银蛇漫舞千家乐	紫燕欢歌万里春
云霞燕舞春光艳	灵草蛇衔寿气浓
丙丁烈焰开新宇	子丑银花兆丰年
丙辉耀福腾淑气	子舍承欢聚太和
丙年有庆猪辞岁	子夜无声鼠报春
丙夜未眠思国计	子时早起讶春光
丙子迎春期两制	陆台携手庆三通
才见肥猪财拱户	又迎金鼠福临门
窗花巧剪吉祥鼠	科技尊称致富神
春风又绿江南岸	好雨复滋甲子年
春鼓频敲鼠嫁女	秧歌竞扭喜盈门
春光曙色兆甲岁	松韵清流庆子年
稻菽千重金浪起	春风万里玉梅开
东风扑面经新雨	江水回头恋子年
亥岁祝福歌九曲	子年尽兴饮三杯
花香鸟语山村好	雨顺风调鼠岁丰
火树银花迎玉鼠	山珍海味列金盘
吉祥鼠报丰收岁	科技花开富裕家
甲兵永戢书康乐	子庶同歌世共和
甲第宏开他造府	子年兴旺我修楼
甲第连云欣发展	子年遍地祝丰收
甲乙科名佳话在	子孙孝友古风存
甲子迎春多瑞霭	文明建国遍春风
嫁女画图呈喜庆	迎春燕子舞祥和
鸠妇雨添正月翠	鼠姑风裹一庭香
九州浪潮逐鼠去	万里东风吹富来
老鼠娶亲成故事	雄鸡迎日报新春
老鼠娶亲鸣鼓乐	羊毫蘸墨写春联
麟角凤毛增国誉	鼠须妙笔点春光
灵鼠跳枝月影晃	春牛耕地谷香飘
灵鼠迎春春色好	金鸡报晓晓光新
龙国群英兴伟业	鼠须彩笔绘蓝图
绿酒添香甲子岁	雪花献瑞大丰年
年画喜人鼠嫁女	红梅傲雪鹊鸣春
鹊喳梅放春迎户	鼠报年来福满门
壬遇深恩心谢党	子图大业力描春
三春花雨润甲岁	十亿神州庆子年
十二时辰鼠在首	一年四季春为头
豕去鼠来新换旧	星移斗转腊迎春
鼠怀不可告人事	年到非常吉庆时
鼠女出嫁千里外	钟声敲响两年间
鼠无大小名称老	年接尾头岁更新
鼠颖描春成画稿	羊毫触墨舞龙蛇
肃贪惩治官仓鼠	正本当纠裙带风
岁月峥崂逢子鼠	江山锦绣倾甲年
跳舞唱歌庆子岁	题诗作对颂甲年
万千气象开新景	一代风流壮鼠年
万千禽兽尊为子	十二生肖独占先
午夜钟声响且远	子时月色亮而圆
务本神农播百谷	刺贪硕鼠吟三章
消除鼠害人人事	造福家邦岁岁昌
一日时辰子为首	十二生肖鼠占头
银花火树迎金鼠	海味山珍列玉盘
银花万簇迎金鼠	火树千株展玉龙
莺歌燕舞春添喜	豕去鼠来景焕新
宰掉肥猪开美宴	迎来金鼠庆新春
子来亥去年更岁	斗换星移日转轮
子年大有山河壮	甲岁丰盈日月新
子时一到开新律	鼠岁三春报好音
子岁人奔新富路	甲年众改旧乾坤
子夜佳章茅盾著	鼠偷奇案况钟察
子夜鼠欢爆竹乐	门庭燕舞笑声喧
子夜钟声燃爆竹	鼠年吉语化春联
祖国健儿兴骏业	鼠须彩笔绘宏图
常在蟾宫攀桂树	今临禹甸送丰年
丁帘卷雨饶春意	卯酒盈杯祝丰年
东方日出金乌艳	除夕月升玉兔皎
东风放虎归山去	明月探春引兔来
虎奔千里留雄劲	兔进万家报吉祥
虎过关山添活力	兔攀月桂浴春晖
虎年喜结丰收果	兔岁欣开幸福花
虎年已去春风暖	兔岁乍来喜气浓
虎去雄风惊五岳	兔开健步跃三江
虎去雄风镇五岳	兔生瑞气秀三春
虎岁刚饮祝捷酒	兔年又放报春花
虎岁欢歌香港返	兔年喜庆澳门归
虎岁三十爆竹脆	兔年初一对联红
虎岁扬威兴骏业	兔毫着彩绘宏图
虎岁扬威兴骏业	兔年献彩立新功
虎尾回头添胜利	兔毫扎笔写风流
虎啸群山辞旧岁	兔奔匝地庆新春
虎啸深林增瑞气	兔驰沃野益新风
虎越雄关踪影去	兔临春境晓光新
虎振雄风留浩气	兔迎盛世启新程
虎振雄风留浩气	兔迎盛世蔚新春
虎走三关鸡报晓	兔升九域鹿鸣春
欢送戊寅丰稔岁	喜迎乙卯幸福春
金杯醉酒乾坤大	玉兔迎春岁月新
金虎腾跃风流世	玉兔笑迎锦绣春
卯时美景花方艳	兔岁良辰酒更醇
卯至东方蓬勃日	兔来华夏振兴时
门户临风迎春入	高楼触月接兔归
庆玉兔今年奋起	祝金龙明岁腾飞
山中虎啸昌新运	月里兔欢启宏图
深山虎啸雄风在	绿野兔奔好景来
深山虎啸雄风在	绿野兔奔美景来
岁首喜看玉兔跃	耳边犹有金龙吟
岁岁痛饮祝捷酒	兔年怒放报春花
兔奔千里传春信	龙起九霄壮国威
兔镜常圆人盼好	龙甲时耀国期安
兔魄常圆花正好	阳光普照景常春
兔跃千山传喜讯	龙腾万里展英才
喜对良宵玩玉兔	笑同胜友赏新春
喜兔年初开春色	继虎岁再展宏图
喜兔年初露春色	继虎岁大展宏图
喜玉兔今年奋起	祝巨龙明岁腾飞
艳阳高照门庭瑞	玉兔喜临世纪新
乙有长风万里至	卯迎旭日九州春
寅去卯来腾瑞气	虎归兔到发祥光
玉户临风迎兔入	高楼揽月接春来
玉兔报春田野绿	金鸡唱晓艳阳红
玉兔呈祥家家乐	金龙兆瑞步步高
玉兔毫光生紫气	金龙捷足入青云
玉兔欢奔芳草地	金乌腾跃碧云天
玉兔机灵承虎气	金乌活跃显狮威
玉兔月中勤捣药	金牛地上恪耕田
月里嫦娥舒袖舞	人间玉兔报春来
月中玉兔下凡界	陌上金鸡报晓春
八骏荣归除夕夜	三春新谱放羊歌
八骏嘶风传捷报	五羊跳跃展新图
白羊越涧探春景	紫燕绕梁报福音
百凤迎春朝旭日	五羊衔穗兆丰年
宝马腾飞迎福至	灵羊起舞报春来
北岭春深宜牧马	南疆草浅待牵羊
不舍风驰追马迹	行看岁稔话羊年
才听骏马踏花去	又见金羊献瑞来
草肥水甜牛羊壮	人杰地灵五谷香
长空载誉夸天马	大地回春颂吉羊
驰骋春风追丽日	扶摇羊角步青云
雏鸭报春江水暖	灵羊衔穗稻花香
春草茸茸催马壮	碧溪潺潺助羊肥
春露秋霜连广宇	羊肠鸟道变通途
春满神州舒画卷	羊临华夏入诗篇
春染红棉迎旭日	羊衔金穗报丰年
催马唤羊逢盛世	叱云沐雨览新春
得意春风催快马	解人新岁献灵羊
得意春风仍疾马	连天碧草又宜羊
得意春风扬马首	宜人景色赖羊毫
庚午祝捷神马去	辛未报喜宝羊来
好鸟鸣春歌盛世	吉羊启运乐升平
画展春城描特色	诗题羊石纪新春
吉羊得草延春色	紫燕衔泥落好家
吉羊健步迎春至	洪福齐天及地来
金凤呈祥人得意	玉羊衔瑞事称心
金驹辞岁羊报吉	丹凤朝阳燕迎春
金马奔驰改革路	银羊欢跃太平年
金马扬蹄抒远志	玉羊接力展宏图
金穗飘香香四季	玉羊报喜喜千家
九州百族辞马岁	两岸三通接羊年
骏马功成领功去	吉羊捷足报捷来
骏马腾飞成壮举	灵羊起步赴新程
骏业辉煌归历史	羊毫遒劲谱新篇
骏业已开休驻马	鸿图再展莫亡羊
鲲鹏展翅扶羊角	莺燕欢歌送马蹄
老马奋蹄知路远	羔羊跪乳感恩深
老马识途辞旧岁	灵羊衔穗报丰年
老马识途归故里	羔羊跪乳报春晖
老马识途终有意	羔羊跪乳最多情
灵羊捷足登新境	骏马奋蹄向未来
灵羊下界盈门喜	乳燕衔泥满院春
羚羊挂角挑春色	喜鹊登枝报福音
龙凤腾飞迎一统	马羊接力赛三春
马步生风辞旧岁	羊毫挥墨写佳联
马驰碧野凯歌壮	羊跃青山景色新
马驰大道征途远	羊上奇峰景色娇
马驰万里传捷报	羊越千山奏凯歌
马驰原野繁花茂	羊跃神州事业兴
马甲雄骑迎胜利	羊羹美酒庆丰收
马年事事如人意	羊岁时时报福音
马年已绘丰收景	羊岁继吟致富诗
马首关情吟妙句	羊毫随意绘新图
马首是瞻跟党走	羊毫在挥为民挥
马首是瞻新世纪	羊毫尽绘好春光
马岁荣光辉日月	羊毫遒劲续春秋
马岁事事合民意	羊年处处沐春风
马岁事事如人意	羊年时时洽春风
马蹄踊跃驰千里	羊角扶摇上九霄
马驮硕果归山去	羊踏青坪报喜来
马尾松劲承雨露	羊毫妙笔点春光
马尾松青凝瑞雪	羊毫笔墨舞春风
骑马牧羊歌盛世	顶凌踏雪报新春
人怀远志驰良马	世易新春唤白羊
神骏回眸丰稔景	灵羊翘首吉祥图
神马行空普天瑞	仙羊下界遍地春
世纪春风萌绿草	山乡柳笛放群羊
世纪更新花吐艳	春风送暖瑞呈祥
世上尘埃随马尽	人间春色逐羊来
誓做长征千里马	争当改革领头羊
岁焕新风燕剪柳	春来大地羊铺云
岁届新春人福寿	羊衔金穗业丰收
天涯芳草绿马蹄	华夏玉羊欢羊毫
万树争荣添翠色	五羊献瑞报佳音
万象更新新世纪	五羊献瑞瑞门庭
万象已随新律转	五羊争跃好春来
五羊城中春光好	九州域内人面新
五羊结彩迎新纪	六畜兴旺报好年
五羊衔穗年丰稔	双燕迎春岁吉祥
五羊献瑞人增寿	百鸟鸣春喜盈门
五羊献瑞增春色	百鸟争鸣唱福音
惜别垂杨难系马	喜瞻叱石尽成羊
喜得马年成骏业	笑看羊岁展鸿图
喜看阳春花千树	笑饮新岁酒一杯
小道羊肠无阻碍	雄心捷足好登攀
驯马腾飞千里路	牧羊更上一重峰
羊归陇上春来早	马识归途业告成
羊角扶摇九万里	马蹄奔向二千年
羊年喜千家祝福	国运昌万物生春
羊群簇拥千堆雪	燕子翻飞一世春
羊群拥起千堆玉	稻浪浮来万亩金
一片白云羊变幻	千条翠柳燕翻飞
英雄跨马扬长去	龙女牧羊载福来
犹思骏马奔腾急	更赞矫羊奋发先
玉树葱茏皆出色	金瓯稳固不亡羊
玉羊启泰迎春至	金马奋蹄载誉归
玉宇澄清观燕舞	草原茂盛喜羊欢
大圣除妖天佛路	天蓬值岁兆丰年
狗守家门旧主喜	猪增财富新春欢
国泰民安戌岁乐	粮丰财茂亥春兴
两年半夜分新旧	万众齐欢接亥春
犬过千秋留胜迹	猪肥万户示丰年
骚人乐撰新春对	墨客欣书亥岁联
天好地好春更好	猪多粮多福愈多
戌年引导小康路	亥岁迎来锦绣春
戌岁乘龙立宏志	亥年跃马奔小康
衣丰食足戌年乐	国泰民安亥岁欢
猪多粮足农家富	子孝孙贤亲寿高
辞戊辰金龙述职	迎已巳银蛇报春
家运每随国运盛	小龙总傍大龙飞
金蛇狂舞春添彩	玉树临风喜满门
龙飞蛇舞升平岁	燕语莺歌盛世春
龙含宝珠辞旧岁	蛇吐瑞气贺新春
龙蛇共舞万家乐	鞭炮齐鸣四海春
龙腾祥云门接福	蛇吐瑞气户迎春
龙吟碧落存余韵	蛇舞神州唱大风
墨泼山水抒斗志	笔走龙蛇颂新春
蛇尾如鞭催骏马	马蹄似鼓送金蛇
巳岁迎春花开早	蛇年纳福喜报多
戊辰传捷龙辞旧	己巳报春蛇迎新
祥龙兆祥蛇兆福	喜鹊报喜梅报春
玉龙战罢欣奏凯	金蛇舞起喜迎春
不知索取只知奉献	勿问收获但问耕耘
灭鼠消灾粮丰人寿	养牛致富国裕家康
喜看大地莺歌燕舞	笑迎农家马壮牛欢
花果飘香美哉乐土	猴年增色换了人间
金猴献礼家家顺利	喜鹊闹春事事吉祥
玉燕嬉春九州铺锦	金猴贺岁一国呈祥
丙穴鱼生人间改岁	寅方斗指天下皆春
春风浩荡花香鸟语	岁月峥嵘虎跃龙腾
虎跃龙腾九州焕彩	风调雨顺五谷丰登
牛奔福地普天献瑞	虎卧华堂满院生辉
势如破竹人欢马叫	安若泰山虎踞龙盘
紫气东来江山如画	红旗招展龙虎扬威
祖国富强神龙活虎	人民幸福舞燕飞莺
邦兴国治鸡唱门庭	春暖花开犬蹲院里
丹凤来仪春回大地	金鸡报晓福满人间
喜庆新春闻鸡起舞	欣逢盛世跃马扬鞭
不知索取只知奉献	勿问收获但问耕耘
灭鼠消灾粮丰人寿	养牛致富国裕家康
喜看大地莺歌燕舞	笑迎农家马壮牛欢
柏叶为铭椒花献瑞	龙缠肇岁凤纪书元
璧合金瓯神州焕彩	龙腾玉宇世纪更新
大地春回凤鸣盛世	中华崛起龙有传人
大业中兴宏图再展	神龙起舞祖国长春
华夏龙腾春晖无限	神州虎跃气象万千
锦绣前程龙腾虎跃	辉煌胜纪燕舞莺歌
龙的传人强邦富国	春之使者润土丰年
龙凤炳文神州焕彩	鲲鹏展翅华夏腾飞
龙凤呈祥阳春锦绣	鲲鹏展翅华夏腾飞
龙启吉祥云蒸霞蔚	花开富贵人寿年丰
龙上高天凤翔过树	春盈大地花漫神州
龙腾云海凤翔天宇	春满江山花漫神州
龙钟传技不留一手	老树著花贵有繁枝
绿抹柳梢红燃花萼	春临世界喜降人间
四柱擎天九龙腾跃	八仙过海百姓安康
兔腾大地清辉万里	龙舞长空捷报千传
吞云吐雾金龙崛起	展志舒情彩凤腾飞
不知索取只知奉献	勿问收获但问耕耘
灭鼠消灾粮丰人寿	养牛致富国裕家康
喜看大地莺歌燕舞	笑迎农家马壮牛欢
春风得意马驰千里	旭日扬辉光照万家
大海方平千帆竞发	征途正远万马奔腾
好雨知时百花齐放	春风得意万马奔腾
金戈铁马扬眉吐气	火树银花浴雪迎春
锦绣山河春和世泰	峥嵘岁月马叫人欢
骏马嘶风九州辞旧	杏花沐雨四海迎新
快马加鞭振兴祖国	闻鸡起舞建设家园
绿水青山九州生色	金戈铁马四海扬威
马蹄踏碎一穷二白	燕子衔来万紫千红
马跃人欢九州欢治	鱼肥秧壮四海春浓
明媚春光百花竞放	昌隆国运万马奔腾
鸟语花香满园春色	人欢马叫一路凯歌
庆盛世雄狮轻起舞	展宏图快马猛加鞭
山舞银蛇春光烂漫	原驰骏马节日欢腾
同心同德宏图再展	群策群力快马加鞭
喜盈门天乐人亦乐	春及第马驰志也驰
一夜报春百花齐放	三阳开道万马奔腾
月圆花好鸟飞鱼跃	雨顺风调马壮人欢
跃马迎春春风扑面	抬头见喜喜气盈门
海滟河清龟蛇献寿	风和日丽桃李争春
龙凤呈祥招财进宝	龟蛇献瑞纳福迎春
龙腾碧海人间改岁	蛇舞青山大地皆春
龙舞庚辰功勋卓著	蛇荣辛巳岁月光辉
世纪图新金蛇曼舞	神州大治玉宇澄清
岁序更新龙蛇竞舞	春风初度莺燕争鸣
辛岁迎春流金溢彩	巳年跨纪策马扬鞭
春雨晓风花开五色	鼠须麟角力扫千军
一纪开端共迎金鼠	三春肇始同举玉杯
春归月殿钟催玉兔	誉满中华鼓舞金龙
春回大地百花吐艳	兔跃青山万物生辉
虎啸千山声声响应	兔驰万里步步腾飞
日暖福州春晖万里	兔回大地气象一新
送虎岁共庆山河壮	迎兔年齐歌业绩新
玉兔出行满天春色	山君归隐一路雄风
北斗光明春台起凤	南溟壮阔羊角搏鹏
碧草白羊三春图画	金戈铁马万里征途
福鹿吉羊三元开泰	尧天舜日万象更新
过佳节方知红日暖	度阳春倍觉党恩深
立志当怀虎胆驰骋	求知莫畏羊肠扶摇
绿草如茵羊盈瑞气	红桃似火猴沐春风
时雨春风五羊献穗	尧天舜日百凤朝阳
送马年春花融白雪	迎羊岁喜鹊闹红梅
万象更新山青水秀	五羊献瑞日丽春华
一派生机阳春映日	满天焕彩浩气腾云
迎新春应赞猪为宝	辞旧岁莫忘犬看家
龙留喜气喜盈门户	蛇闹春光春满山川
腊尽春归山村添喜气	牛肥马壮门户浴春风
鼠去牛来一元欣复始	春明日丽万象喜更新
喜鹊登梅百族迎佳节	金牛献瑞万里笑春风
金猴棒奋千钧除腐败	盛世家兴万富民康宁
白虎替青牛招财进宝	黄莺鸣翠柳辞旧迎新
虎跃龙腾创人间奇迹	莺歌燕舞描大地春光
虎跃龙腾有天皆丽日	花香鸟语无地不春风
花团锦簇江山添异彩	虎啸龙吟华夏壮神威
金牛辞旧携凯歌而去	乳虎迎春带捷报新来
瑞雪兆丰年年年大吉	丑牛接寅虎虎虎生威
岁月逢春山河添锦绣	人民思治龙虎振精神
效虎豪吟放怀歌富岁	闻鸡起舞挥笔颂春光
祖国腾飞大鹏振羽翼	宏图再展乳虎显神通
腊尽春归山村添喜气	牛肥马壮门户浴春风
鼠去牛来一元欣复始	春明日丽万象喜更新
喜鹊登梅百族迎佳节	金牛献瑞万里笑春风
百姓喜金瓯同歌宝鼎	九州辞玉兔共接神龙
东海跃明珠金龙献岁	南天开淑景俊鸟鸣春
虎跃龙腾建功九万里	莺歌燕舞造福两千年
起凤腾龙千家争贡献	移山填海十亿尽风流
四柱擎天看神州巨变	五星焕彩引玉龙腾飞
喜气满庭阶春来福地	凯歌传江海鱼跃龙门
玉兔回宫喜迎新世纪	金龙下界更展大宏图
腊尽春归山村添喜气	牛肥马壮门户浴春风
鼠去牛来一元欣复始	春明日丽万象喜更新
喜鹊登梅百族迎佳节	金牛献瑞万里笑春风
百尺竿头重跨千里马	十亿人民更上一层楼
百花争艳祖国春光好	万马奔腾改革事业兴
赤帜舞东风江山如画	赤骝奔大路祖国长春
工农携手共跨千里马	干群并肩同上一层楼
举步昂首攀登十八盘	跃马扬鞭飞越天柱峰
快马舞东风春盈四海	梅花香大地喜满九州
马壮牛肥山村添喜气	地灵人杰门户沐春风
鸟语花香九州春光好	人欢马叫四季画图新
奇迹不奇英雄能创造	远征非远良马自奋蹄
人欢马跃开创新局面	燕舞莺歌喜庆夏收年
十亿神州共驰千里马	四化建设更上一层楼
五谷丰登银蛇载誉去	百花争艳金马踏春来
喜四化征途莺歌燕舞	看九州大地马叫人欢
新貌新风喜迎新世纪	好鞍好马驰骋好前程
鱼跃鸢飞光景随时好	人欢马叫春潮逐浪高
刚过龙年走上康庄道	新逢蛇岁迎来改革潮
佳节舞龙蛇千家致富	东风荣草木万户迎春
龙去雄风在江山不老	蛇来灵气生岁月常新
桃李迎春北国江山丽	龟蛇献瑞南疆岁月新
喜气闹新年千家报喜	春风暖蛇岁万户迎春
抗洪抢险虎年呈异彩	创业兴家兔岁立新功
玉兔生辉照宽改革路	春风得意吹绽文明花
改革起宏图神州巨变	丰年添笑语万事吉祥
快马加鞭不坠腾飞志	吉羊昂首更添奋发心
留胜迹水秀山明草茂	谱新歌羊肥马壮春荣
岁序更新马年留胜绩	春风初度羊志展鸿猷
万马扬蹄踏凯歌而去	群羊翘首唤春信即来
喜鹊迎春红梅香瑞雪	吉羊贺岁金穗报丰年
艳阳高照江山添锦绣	壮志常存祖国更富强
张灯结彩欢庆丰收岁	跑马耍羊喜迎改革春
张灯结彩欢庆丰收岁	跑马耍羊喜迎艳阳春
骏马金鞍跨上康庄路	肥猪元宝迎来大丰年
盘瓠神将上天去报喜	天蓬元师下界来除灾
昨夕犬年欢歌迎大地	今朝猪岁新景满神州
爆竹声声龙吟随腊去	欢歌阵阵蛇舞伴春来
喜炮闹元春千家接喜	春风荣蛇岁万户迎春
庆虎岁把酒高吟虎跃曲	祝丰年扶犁又唱丰收谣
迎虎年敢逐改革拦路虎	送牛岁勇当奉献老黄牛
迎新春处处呈文明气象	入虎岁人人当改革先锋
除夕猴在山重享齐天乐	迎春鸡报晓高唱东方红
猴岁呈祥长空五光十色	鸡年纳福大地万紫千红
百鸟鸣春堪喜人间换岁	群龙献瑞欣逢世纪更新
南疆雨北国风风调雨顺	东海龙西山凤凤舞龙飞
为国争光可上九天揽月	给民造福敢入四海擒龙
玉兔回蟾宫长空悬朗月	金龙上华表大地庆新春
爆竹迎春春丽五湖四海	红梅报喜喜催万马千军
步新潮须骑骏马驰千里	兴伟业应唤春风惠万家
才过小龙年又催千里马	曾经大风浪更上一层楼
春日融融万树繁花竞放	红旗猎猎千骑骏马争先
宏图大展成就行行伟业	骏马奔腾飞越道道雄关
听遍地豪歌征人添虎劲	看漫天彩霞战马长精神
万马奔腾为江山添锦绣	宏图再展与日月竞光辉
龙蛇同体角有角无当辨	已巳异头尾长尾短当分
日丽风和喜奏金蛇曼舞	民强国富远瞻骏马腾飞
天马行空日丽风和雨顺	灵蛇在世政通国泰民安
送虎岁盈盈硕果山村景	迎兔年丽丽宏图祖国春
送金虎硕果丰收千里艳	迎玉兔宏图再展万年青
兔岁初临健步已驰千里	虎年虽去雄风犹镇八方
红杏丛中朝见牛羊出圈	绿柳郊外夕闻鸟雀归林
喜洋洋绿水青山春永驻	美泰泰丰衣足食福无边
羊笔如花写就辉煌岁月	春风似剪裁成锦绣江山
乐辞鼠岁处处丰收人人乐	歌颂牛年家家富裕户户歌
镰运锤挥万古江山开盛世	龙骧虎奋九州儿女创殊荣
羊岁去矣应记取亡羊教训	猴年来兮当发扬金猴精神
虎跃龙腾碧海黄山妆玉宇	莺歌燕舞春风旭日蔚神州
虎跃龙腾华夏人民多俊杰	莺歌燕舞阳春山水尽朝晖
牛耕广野丑年犁出文明路	虎跃深山寅岁图开舜尧天
岁步寅年喜庆团圆同把酒	珠还合浦欢歌一统共迎春
喜庆牛年两制先迎香港还	欢歌兔岁亿民再赞澳门归
栽竹栽松竹隐凤凰松隐鹤	培山培水山藏虎豹水藏龙
彩凤高翔恋我中华春不老	金鸡喜唱歌斯盛世乐无穷
大圣辞年万里河山留瑞霭	雄鸡报晓千家楼阁映朝晖
大业方兴五星旗展金鸡唱	小康在望四化图开彩凤飞
点点梅花笑迎雄鸡朝天唳	声声爆竹欢送大圣载誉归
鸡唱门庭四海升平歌舜日	犬蹲院里九州盛世乐尧天
鸡唱三通万家春正乾坤气	凤鸣两岸一树梅开天地心
鸡唱月归一线长天皆瑞霭	犬歌日出九州大地尽朝晖
捷报频传圣猴舞棒辞岁去	宏图再展金允高唱迎春来
金鸡报晓改革似春风化雨	彩凤朝阳腾飞如旭日升华
金鸡报晓时转三阳迎淑气	红梅竞放花开五福庆丰年
雷震南天滚滚春潮生九域	鸡鸣大地彤彤旭日耀寰球
人寿年丰金猴辞岁归帘洞	民安国泰玉羽司晨报晓春
神猴辞岁保驾护航奔富路	金凤迎春昂头振翼唱东风
雄鸡唱韵万户桃符新气象	大地回春群山霞彩富神州
雄鸡喔喔颂尧天邦兴国治	腊狗汪汪歌舜日春暖花开
在圣班师一路凯歌笳鼓竞	雄鸡振翅几声雅唱瑞云生
紫燕迎春一路东风歌大治	金鸡唱晓九州时雨润小康
乐辞鼠岁处处丰收人人乐	歌颂牛年家家富裕户户歌
爆竹飞花四海升平庆富庶	金龙献瑞九州欢乐唱丰年
爆竹迎春春光明媚人心畅	金龙还世世纪崭新国力雄
藏龙卧虎华夏大地春常地	人杰地灵文明古国尽朝晖
大开大放虎跃龙腾奔四化	双节双增莺歌燕舞入三春
改天换地狮啸八荒光八极	揽月摘星龙吟九派熠九州
鼓角争鸣跨纪龙骧腾热浪	旌旗漫卷开元虎步舞长风
虎步龙骧共创九州新世纪	莺歌燕舞同观四海好风光
虎将三千曾驭红鬃还伏虎	龙人十亿才跨赤兔又乘龙
华夏龙腾长城内外皆春色	神州虎跃大江南北尽朝晖
华夏腾飞时势造就新业绩	巨龙昂首英雄独领好风骚
画海诗天神州美景能人绘	云龙山虎禹甸宏图巧手描
荆艳莲香龙国迎春花织锦	日新月异宏图焕彩景迷人
龙虎精神龙子龙孙功不灭	江山锦绣江南江北水长流
龙闹北溟千里冰凌千里雪	春回南岭万枝火桔万枝梅
龙年龙裔看龙舞龙飞天上	春节春风送春光春满人间
龙种自与常人殊况逢龙岁	鹏鸟岂堪同日语绝胜鹏搏
岁届龙年好跳龙门题雁塔	身弥虎劲敢凭虎胆占鳌头
天下皆春长街喜看龙灯舞	人间改岁小院欣闻爆竹鸣
兔窟三营去岁财经已搞活	龙门一跃今年体制再更新
兔卧蓝田万里春风舒碧野	龙腾玉宇千家笑语乐新程
兔跃龙腾瑞盈玉宇天光丽	珠还璧合春满金瓯世纪新
兔走乌飞大舞兔毫辞兔岁	龙腾虎跃敢攀龙角接龙年
物华天宝欣闻禹域鸣雏凤	人杰地灵喜看神州起卧龙
喜值龙年经济腾飞增国力	乐迎盛世人民幸福焕春光
绣水描山神州大地春常在	藏龙卧虎盛世人家福永存
玉兔归宫新春喜气连天外	金龙出海改革波澜动地来
玉兔归时羡慕人间春色美	金龙跃处喜看华夏画图新
玉兔回宫永羡人间春色舞	金龙献岁常牵天际彩云归
玉兔追风喜接澳门归祖国	金龙运气宏开新纪写春光
乐辞鼠岁处处丰收人人乐	歌颂牛年家家富裕户户歌
爆竹一声喜送巳蛇留庶绩	华灯万盏欣迎午马展嘉猷
策马争春马跃马年加马力	驾龙追日龙腾龙国振龙威
大地回春锦绣河山添异彩	征途跃马英雄儿女着先鞭
凤舞龙腾腾龙兴国创新业	人欢马跃跃马扬鞭赴前程
改革开放神州巨变真无比	奋发图强骏马奔腾大有为
花红柳绿河山壮丽门庭秀	民富国强龙马奔腾世纪新
继往开来世纪春光无限好	承前启后神州骏马有奔头
继往开来蹄声似鼓惊天地	兴邦强国志气如虹展画图
金戈铁马三军猛士戍边邑	伟业殊勋一代精英振国威
旧岁蛰蛇蛇舞青山山愈秀	新春跃马马奔大路路更宽
快马加鞭协力同心跟党走	葵花吐蕊栉风沐雨向阳开
老骥伏枥退休续谱夕阳曲	苍松傲雪余生再唱春牛歌
老马识途奋驾长车奔富路	银蛇献岁昭苏万物舞东风
丽日蓝天万树繁花争早放	阳关大道千骑骏马着先鞭
柳拂春风马蹄得意奔新路	云蒸丽日喜鹊登枝报福音
气贯长虹四化征途催战马	志凌霄汉十亿英雄唱新歌
千帆竞发几经风雨几经浪	万马奔腾一路凯歌一路春
蛇舞取胜除暴安良政局稳	马到成功兴益除弊国力强
为国争辉万马齐奔改革路	给民造福千帆竞发富春江
小龙辞岁好凭妙手书鹏赋	骏马迎春当显雄才唱大风
银蛇归去盛赞人间春色美	金马奔来争夸祖国气象新
雨润三春披红戴绿千山舞	旗飘四化跃马扬鞭万众忙
玉宇澄清花香鸟语升平世	金瓯永固马叫人欢幸福春
跃马扬鞭四化征途奔万马	扬帆契浪一江春水涌千帆
展宏图九州英才扬鞭跃马	创伟业四海豪杰破浪飞舟
展智施能雄心共创千秋业	扬鞭跃马矢志同奔万里程
大地春回千里金涛香万户	小龙蛰起九州紫气贯长虹
大地迎春柳伴梅香招蝶舞	高天降雨犂掀黄土应蛇行
凤起蛟腾四海英才齐报国	龟动蛇出九州风物笑迎春
凤舞龙飞锦绣河山添锦绣	蛇祥龟瑞富强中国更富强
龙归大海滚滚春潮逐浪起	蛇舞青云浓浓喜气盈门来
龙舞雪花四野寒风随雪尽	蛇衔春色九天暖意逐春回
龙骧新纪党政军民同春进	蛇步锦程工农商学共腾飞
蛇至龙回重开新岁人间景	山欢水笑又度佳节天下春
四海龙腾盈门喜气临春到	九州蛇舞满面春风报喜来
旭日扬辉崭新世纪呈春色	灵蛇起舞大好河山架彩虹
玉燕翻飞千秋大业千秋世	金蛇狂舞万里春风万里歌
两个文明同建设无分甲乙	四项原则共坚持永传子孙
雪花献瑞五龙鳞甲飞大地	绿酒添欢家人父子庆丰年
雪花献瑞玉龙飞起三百万	绿酒添欢金鼠报来十二时
北斗回寅万户金鸡争唱晓	东风送暖九霄玉兔喜迎春
虎慢归山因贪人间好春色	兔急下界为览世上新画图
虎岁三十爆竹声声辞旧岁	兔年初一红联对对迎新年
虎镇千山虎威长励英雄志	兔营三窟兔智频催改革风
喜今朝玉兔欢跃九州生色	望明岁金龙奋起万里腾飞
玉兔出宫倾慕人间春色美	金龙潜海畅游祖国江山娇
春暖人心世界三千同雀跃	风搏羊角云程九万共鹏飞
国富民殷羊毫挥颂千秋业	年丰人寿燕剪裁成万点春
浩气常存频加马力奔新路	雄风不减再握羊毫绘壮图
骏马奔驰满载乌金辞岁去	吉羊起舞豪吟白雪报春来
骏马辞年不懈奔腾千里志	吉羊献岁同迎欢乐万家春
骏马荣归一路梅花频送笑	吉羊欢驾九州绿草快铺春
老马识途破雾导航奔胜境	吉羊接力承先启后展宏图
马去蹄香北国又添千里马	羊来春暖南疆再现五仙羊
马去羊来华夏腾飞添马力	龙吟虎啸天公抖擞降龙才
马首是瞻美酒千盅迎曙色	羊毫初试豪情万斛写春光
门对青山羊兔群群嬉碧毯	窗含绿水鸭鹅队队戏清波
前路辉煌笑看骏马追风去	雄雷霹雳喜见商羊带雨来
瑞雪绽红梅君正啸天傲地	劳春织绿草我来放马牧羊
三阳开泰来处处三春美景	五福骈臻至家家五谷丰登
岁届吉羊燕舞莺歌齐祝福	年逢盛世桃红柳绿尽芳菲
天马班师捷报频传惊宇宙	仙羊降世宏图再展耀神州
万马消尘蹄声响彻三千界	五羊衔瑞春意浓于二月花
先富后富你富我富大家富	羊多猪多钱多粮多喜事多
羊笔如椽描山绘水书春意	马蹄腾雪步韵留香报福音
羊酒微醺酡颜人共桃符艳	春风乍拂捷报声随爆竹传
月异日新不少羊肠成大道	春和景泰好多蜗舍变高楼
自改革来千古羊肠成大道	由开放始全新人面满春风
红梅点点盘瓠傲霜随岁去	丽日融融天蓬报喜伴春来
盘瓠将军奉命辞岁报功去	天蓬元帅领旨迎春送宝来
大地迎春柳伴梅香招蜂蝶	文坛焕彩笔掀墨浪舞龙蛇
金龙穿云端裁剪千千锦缎	玉蛇舞大地巧绣万万彩旗
鼠岁报佳音市场兴旺迎胜利	牛年逢盛世香港回归庆团圆
腊酒谢金鸡唱遍神州歌大有	春风催吉犬迈开健步跃高峰
丑岁建奇功香港回归昌国运	寅年兴大业宏图展现壮情怀
虎年喜虎劲攻关夺隘皆如虎	春节焕春光绣水描山总是春
牛年虽过去牛劲更增多奉献	虎岁喜临门虎威大振有精神
寅时入虎年十亿人民振虎劲	佳节描春色九州大地荡春潮
春回大地喜庆新春闻鸡起舞	福满人间欣逢盛世跃马扬鞭
鸡鸣曙日红万里金光辉瑞霭	柳舞春江绿千重锦浪映丹霞
鸡鸣早看天抓住时机求发展	水近先得月紧跟形势上台阶
九域涌新潮四海雄鸡争唱晓	三春辉紫气八方彩凤共朝阳
万象喜回春守信知廉标五德	一元欣复始司晨报午必三鸣
振翅欲冲霄一唱雄鸡声破晓	迎春思试剑三擂战鼓气吞虹
鼠岁报佳音市场兴旺迎胜利	牛年逢盛世香港回归庆团圆
爆竹辞旧岁玉兔毫光生紫气	华灯照新春金龙捷足步青云
改革奏凯歌虎跃龙腾强盛景	文明开新局莺歌燕舞太平春
海是龙故乡龙腾海宇龙光起	春为燕天地燕舞春风燕语新
海是龙故乡龙腾海宇龙兴起	春为花世界花吐春光花盛开
虎跃龙腾万里长征风光无限	花香鸟语九州大地春色正浓
佳节倍思亲厚望台澎同日月	群龙皆起舞欣吟港澳共团圆
卯岁展宏图五湖四海歌大有	辰年逢盛世千村万户讲文明
骑飞虎奋云程广罗八方志士	降蛟龙掌乾坤实现四化宏图
鼠岁报佳音市场兴旺迎胜利	牛年逢盛世香港回归庆团圆
春风会马年一路凯歌迎盛世	紫气开晴宇满天捷报壮新猷
九霄鹏鹏举九霄九霄飞捷报	千里马马奔千里千里荡春风
骏马早迎春一代英豪图改革	黄莺初唱晓千里乐声唱丰收
看旧岁银蛇起舞群山增秀色	喜今朝骏马奔驰九州尽春晖
快马加鞭万里长征始于足下	争分夺秒四化宏图绘在今朝
神州呈瑞彩满天捷报迎旭日	大地迎马年一路凯歌壮春风
万里蓝天莺歌燕舞春光无限	千村碧野马叫人欢淑景连绵
鲜卉挹春风骏马奔腾强国路	神州迎笑语雄狮起舞小康年
小龙舞九州龙伴腊归留胜迹	大骥驰千里骥随春到展宏图
银蛇随腊去农业丰收欣在望	金马送春来国民经济喜腾飞
德政布寰中四海翻腾掀巨浪	春雷鸣广宇长空跃动舞银蛇
改革呼声高老凤争鸣雏凤唱	腾飞接力快大龙引导小龙来
恭祝小龙年锦簇花团呈万象	宏开新玉宇雄伟火箭腾九霄
盛世挹春风芝草灵蛇迎瑞气	丰年歌善政奇山秀水沐朝阳
岁庆小龙年反腐倡廉昌国运	史开新世纪爱岗敬业振民魂
掀改革浪潮神龙载誉回天宇	伴长征号角金蟒迎春降人间
中华大气魄党政同心昌特色	辛巳小龙年军民协力振雄风
海宇尘嚣坚甲牧马立国之道	人寰春暖孺子为牛尽我所能
爆竹辞旧岁玉兔毫毛生紫气	华灯迎新春金龙捷足入青云
爆竹庆新春玉兔毫光生紫气	华灯辞旧岁金龙捷足入青云
洪魔挂降旗重建家园辞虎岁	玉兔开泰运再凭科技奋鹏程
兔岁来矣劝君记取龟兔教训	虎年去也祝您发扬龙虎精神
酣墨沾羊毫记载中华创业史	丹青赋春色绘描改革鼎新图
凯歌阵阵千里马早过玉门关	春风习习带头羊又登泰山顶
马步牵长风长随远景江山好	牵羊迎盛世依然十里杏花红
万马闯雄关春回大地繁花俏	五羊开玉局旗展东风旭日辉
万事本无难只赖吹牛拍马屁	百般都有假谨防屠狗挂羊头
龙飞留荡漾祥云映神州壮美	蛇舞带铿锵吉乐催大众图强
蛇岁纳千祥花开梅兰添秀色	春光迎百福鹊啭城乡报佳音
岁属龙龙布雨雨顺风调呈稔岁	春迎燕燕衔花花团锦簇贺新春
振兴伟大中华道路驰骋千里马	迎接崭新世纪人民团结一条心
大龙传小龙连年奋进经天行地	老凤带雏凤尽日畅鸣悦耳清心
龙携华夏腾飞飞起玉龙三百万	蛇伴新春狂舞舞来银蛇数千条
虎劲长存救命降魔英烈人人颂	兔年新至扶贫效国赤心户户歌
银蛇舞江城美千帆竞发辞旧岁	黄鹤飞楚地阔万物峥嵘迎新春
辞旧岁国共三联赤子丹忱争四化	入龙年江山一统巧手红心建九州
巨龙迎盛世狂欢爆竹声声辞旧岁	喜鹊羡故园起舞梅花朵朵报新春
来自云天出角露牙与虎几番争斗	兴于河海负图衔甲同马一样精神
玉兔欢奔金乌飞飞向春光明媚处	雄狮抖擞巨龙舞舞来华夏太平年
真豪杰无私无畏敢锯孽龙头上角	是英雄有胆有识能拔猛虎口中牙
竞舞龙蛇喜看九州开放天翻地覆	争跨骐骥欢呼十载改革国富民殷
岁序更新蛇归洞府畅述辉煌成就	春风初度马跃神州喜奔锦绣前程
巨龙凌空雄狮拜地爆竹声声辞旧岁	紫燕展翅绿柳吐丝梅花朵朵迎新春
龙游东海马放南山龙马精神传万代	虎啸西冈牛耕北国虎牛威力震千秋
绿抹柳梢红燃花萼燕舞莺歌相比美	春临世界喜降人间龙腾虎跃竞争先
农村兴旺同庆丰收谷似金山棉似海	城市繁荣共迎新岁车如流水马如龙
岁月峥嵘应知花甲易屈指珍惜少壮	江山锦绣乐与赤子同存心服务人民
金猴献礼家家顺利玉燕嬉春九州铺锦	喜鹊闹春事事吉祥金猴贺岁一国呈祥
忆旧岁牛劲冲霄汉神鞭一指神州巨变	看今朝虎威壮中华众志成城经济腾飞
长空五光十色除夕猴在山重享齐天乐	大地万紫千红迎春鸡报晓高唱东方红
大地早回春处处春光好莫把青春负了	龙年多造福人人福中过坐亨清福行吗
兔去龙来四海喜金瓯共祝三通图一统	花明柳暗九州歌宝鼎同期两制乐千秋
玉兔走金鸟飞走走飞飞飞向春光明媚处	雄狮欢巨龙舞欢欢舞舞舞出华夏壮美丽
巳岁不寻常欣瞻祖国繁荣处处管弦歌盛世	蛇年真雅化喜见城乡活跃家家诗酒贺新年
镰运锤挥万古江山开盛世羊岁去矣应记取亡羊教训	龙骧虎奋九州儿女创殊荣猴年来兮当发扬金猴精神
猴去鸡来胜利年终迎胜利猴年赞金猴棒奋千钧除腐败	莺歌燕舞腾飞岁席再腾飞世人歌盛世家兴万富民康宁
